FIPS,County,Black Population,Black with Computer,Black with Dial-up Only,Black with Broadband Internet,Black without Internet Subscription,Black without Computer,White Population,White with Computer,White with Dial-up Only,White with Broadband Internet,White without Internet Subscription,White without Computer,Total Population,Total with Computer,Total with Dial-up Only,Total with Broadband Internet,Total without Internet Subscription,Total without Computer
1001,"Autauga County, Alabama",10375,8365,16,6550,1799,2010,41151,38523,106,35051,3366,2628,54511,49665,122,44213,5330,4846
1003,"Baldwin County, Alabama",18617,15411,12,11819,3580,3206,167035,154801,1085,136384,17332,12234,200476,183895,1278,159639,22978,16581
1005,"Barbour County, Alabama",10910,8108,39,6141,1928,2802,10892,9135,191,7249,1695,1757,23326,18633,230,14574,3829,4693
1007,"Bibb County, Alabama",3805,2377,9,2142,226,1428,16091,13664,38,11699,1927,2427,20522,16521,47,14091,2383,4001
1009,"Blount County, Alabama",791,267,0,228,39,524,49959,42829,740,36409,5680,7130,57119,48672,1034,40874,6764,8447
1011,"Bullock County, Alabama",7688,5259,46,3832,1381,2429,2084,1744,26,1346,372,340,10057,7182,72,5357,1753,2875
1013,"Butler County, Alabama",8934,6098,239,4873,986,2836,10294,8237,114,6984,1139,2057,19809,14897,353,12388,2156,4912
1015,"Calhoun County, Alabama",22684,18972,253,14903,3816,3712,82192,73706,354,64818,8534,8486,112457,99576,607,85411,13558,12881
1017,"Chambers County, Alabama",13153,9409,8,7835,1566,3744,18736,15880,230,14193,1457,2856,33391,26575,238,23291,3046,6816
1019,"Cherokee County, Alabama",1200,1005,0,926,79,195,23516,20330,95,17331,2904,3186,25553,22086,95,18891,3100,3467
1021,"Chilton County, Alabama",4054,3175,11,2009,1155,879,34946,28983,418,22651,5914,5963,43412,35662,429,26855,8378,7750
1023,"Choctaw County, Alabama",5531,4224,35,3003,1186,1307,7302,5883,86,4563,1234,1419,13008,10267,121,7661,2485,2741
1025,"Clarke County, Alabama",11122,6383,6,4342,2035,4739,12835,9718,178,8425,1115,3117,24263,16379,202,12993,3184,7884
1027,"Clay County, Alabama",1934,1530,0,1388,142,404,10552,8870,37,7332,1501,1682,13153,11003,37,9012,1954,2150
1029,"Cleburne County, Alabama",391,264,0,125,139,127,13718,11442,123,9126,2193,2276,14774,12258,123,9594,2541,2516
1031,"Coffee County, Alabama",8605,7488,63,5830,1595,1117,35892,32718,205,29869,2644,3174,50468,45252,289,39890,5073,5216
1033,"Colbert County, Alabama",8577,7074,9,4909,2156,1503,42607,37128,218,31970,4940,5479,54004,46453,259,38587,7607,7551
1035,"Conecuh County, Alabama",5854,3173,0,2166,1007,2681,6341,4274,111,3672,491,2067,12603,7660,111,6051,1498,4943
1037,"Coosa County, Alabama",3415,2395,24,1670,701,1020,6983,5787,58,5134,595,1196,10563,8342,90,6956,1296,2221
1039,"Covington County, Alabama",4762,3636,0,2884,752,1126,30881,25339,261,22447,2631,5542,36881,29961,261,26210,3490,6920
1041,"Crenshaw County, Alabama",3246,2360,0,1643,717,886,9750,7936,36,6707,1193,1814,13719,10874,36,8831,2007,2845
1043,"Cullman County, Alabama",696,550,0,395,155,146,74538,63122,600,52472,10050,11416,80522,68259,741,56839,10679,12263
1045,"Dale County, Alabama",9354,7025,0,5819,1206,2329,33512,29461,298,25536,3627,4051,48182,41417,324,35717,5376,6765
1047,"Dallas County, Alabama",28355,20627,208,16953,3466,7728,11044,9248,85,8028,1135,1796,40153,30497,293,25514,4690,9656
1049,"DeKalb County, Alabama",930,752,0,515,237,178,56698,47863,564,39561,7738,8835,70257,56974,564,46372,10038,13283
1051,"Elmore County, Alabama",14943,12813,82,11244,1487,2130,57349,53067,227,48384,4456,4282,76250,69403,309,63013,6081,6847
1053,"Escambia County, Alabama",10264,5552,30,4564,958,4712,21802,17019,132,14569,2318,4783,34849,24840,206,20988,3646,10009
1055,"Etowah County, Alabama",15490,12553,28,10467,2058,2937,79999,70449,476,60352,9621,9550,101791,88024,510,75050,12464,13767
1057,"Fayette County, Alabama",1922,1396,0,1194,202,526,13945,11323,18,9787,1518,2622,16333,13144,18,11406,1720,3189
1059,"Franklin County, Alabama",1487,1225,75,984,166,262,24250,19766,104,16414,3248,4484,31239,25427,179,21376,3872,5812
1061,"Geneva County, Alabama",2369,1699,0,1312,387,670,22143,18937,420,15841,2676,3206,26321,22267,420,18379,3468,4054
1063,"Greene County, Alabama",6815,4239,145,2869,1225,2576,1439,1061,4,925,132,378,8475,5521,149,3983,1389,2954
1065,"Hale County, Alabama",8742,5645,11,3937,1697,3097,5770,4821,39,4101,681,949,14780,10609,50,8115,2444,4171
1067,"Henry County, Alabama",4668,3148,0,2773,375,1520,11568,10376,281,9081,1014,1192,16821,14022,281,12214,1527,2799
1069,"Houston County, Alabama",27557,20567,336,16358,3873,6990,69426,58978,1423,52757,4798,10448,103188,84688,1810,73581,9297,18500
1071,"Jackson County, Alabama",1596,1358,0,1152,206,238,46218,37613,257,32013,5343,8605,51661,42468,298,35957,6213,9193
1073,"Jefferson County, Alabama",274406,234762,592,190364,43806,39644,323864,298748,1156,273583,24009,25116,643547,573555,1937,495913,75705,69992
1075,"Lamar County, Alabama",1463,1002,6,555,441,461,11936,9778,127,8262,1389,2158,13833,11182,133,9183,1866,2651
1077,"Lauderdale County, Alabama",8866,6671,0,5241,1430,2195,76892,65732,886,55298,9548,11160,90382,76655,895,63844,11916,13727
1079,"Lawrence County, Alabama",3723,2633,146,1528,959,1090,25355,21029,550,15885,4594,4326,33061,27167,827,20045,6295,5894
1081,"Lee County, Alabama",35485,29824,32,24404,5388,5661,101062,95514,333,86978,8203,5548,150715,138363,365,123386,14612,12352
1083,"Limestone County, Alabama",10404,8352,52,7288,1012,2052,69523,62622,230,55047,7345,6901,88774,78422,441,68128,9853,10352
1085,"Lowndes County, Alabama",7677,4799,91,3331,1377,2878,2473,2173,62,1869,242,300,10268,7076,153,5282,1641,3192
1087,"Macon County, Alabama",13699,10568,122,7636,2810,3131,2918,2369,17,1731,621,549,17024,13198,139,9613,3446,3826
1089,"Madison County, Alabama",80754,72222,261,62515,9446,8532,226456,212569,757,198458,13354,13887,344506,319197,1192,292247,25758,25309
1091,"Marengo County, Alabama",10568,7339,225,4944,2170,3229,8807,7274,198,5910,1166,1533,19510,14734,423,10951,3360,4776
1093,"Marion County, Alabama",828,667,0,452,215,161,27292,23160,81,20090,2989,4132,29513,25082,88,21656,3338,4431
1095,"Marshall County, Alabama",1931,1602,0,1459,143,329,76629,66648,284,59278,7086,9981,93723,79440,284,69738,9418,14283
1097,"Mobile County, Alabama",142093,109400,557,89603,19240,32693,233603,207879,1158,186870,19851,25724,404676,342587,1779,298392,42416,62089
1099,"Monroe County, Alabama",8953,4300,56,2243,2001,4653,11675,8062,0,6415,1647,3613,21502,12935,56,9066,3813,8567
1101,"Montgomery County, Alabama",125986,107746,261,93663,13822,18240,77615,71959,193,67088,4678,5656,220262,194546,477,174280,19789,25716
1103,"Morgan County, Alabama",14060,11745,214,8348,3183,2315,89809,80574,972,71197,8405,9235,117157,103172,1186,87340,14646,13985
1105,"Perry County, Alabama",6553,4844,21,3239,1584,1709,2293,1564,17,1074,473,729,8882,6439,38,4322,2079,2443
1107,"Pickens County, Alabama",7844,6004,25,4635,1344,1840,10497,8854,91,7905,858,1643,18879,15236,116,12880,2240,3643
1109,"Pike County, Alabama",11890,7591,268,5937,1386,4299,17649,14632,280,13227,1125,3017,31322,23690,556,20475,2659,7632
1111,"Randolph County, Alabama",4353,3614,74,3362,178,739,16642,14143,353,11573,2217,2499,22039,18532,427,15509,2596,3507
1113,"Russell County, Alabama",24713,20667,77,15517,5073,4046,27605,24545,537,20727,3281,3060,57878,49687,614,40221,8852,8191
1115,"St. Clair County, Alabama",7013,5734,86,4304,1344,1279,73990,67117,823,58624,7670,6873,84793,76184,909,65932,9343,8609
1117,"Shelby County, Alabama",23771,22168,99,19278,2791,1603,161925,154314,392,144777,9145,7611,205758,195644,491,180030,15123,10114
1119,"Sumter County, Alabama",8894,5844,113,3913,1818,3050,2936,2652,22,2272,358,284,12203,8845,135,6530,2180,3358
1121,"Talladega County, Alabama",24432,19830,318,15790,3722,4602,49584,42985,337,36835,5813,6599,77492,65966,655,55156,10155,11526
1123,"Tallapoosa County, Alabama",10952,8275,50,7040,1185,2677,27727,23817,63,21634,2120,3910,40137,33517,113,29873,3531,6620
1125,"Tuscaloosa County, Alabama",62261,50534,82,44268,6184,11727,119758,110294,201,101016,9077,9464,194251,171814,283,154812,16719,22437
1127,"Walker County, Alabama",3743,3159,103,2255,801,584,57377,48216,554,39565,8097,9161,64022,53743,671,43612,9460,10279
1129,"Washington County, Alabama",4078,3027,0,2115,912,1051,10814,9196,62,6154,2980,1618,16603,13837,62,9771,4004,2766
1131,"Wilcox County, Alabama",7714,5526,419,3484,1623,2188,2825,2261,56,1790,415,564,10645,7893,475,5327,2091,2752
1133,"Winston County, Alabama",20,0,0,0,0,20,22301,17613,267,13658,3688,4688,23604,18669,267,14476,3926,4935
2013,"Aleutians East Borough, Alaska",5,5,0,5,0,0,376,350,0,295,55,26,2053,1818,0,1495,323,235
2016,"Aleutians West Census Area, Alaska",78,76,0,71,5,2,1140,1097,2,860,235,43,4354,4161,2,3405,754,193
2020,"Anchorage Municipality, Alaska",15519,14881,31,13636,1214,638,172357,168041,721,159246,8074,4316,290170,280743,1025,261872,17846,9427
2050,"Bethel Census Area, Alaska",109,104,0,91,13,5,1587,1529,0,1391,138,58,17217,14979,2,12817,2160,2238
2060,"Bristol Bay Borough, Alaska",0,0,0,0,0,0,414,396,2,374,20,18,855,801,10,709,82,54
2068,"Denali Borough, Alaska",4,4,0,2,2,0,1246,1211,0,1121,90,35,1569,1533,0,1441,92,36
2070,"Dillingham Census Area, Alaska",22,22,0,22,0,0,571,544,0,493,51,27,4664,4052,14,3609,429,612
2090,"Fairbanks North Star Borough, Alaska",3775,3476,0,2753,723,299,68847,66967,354,59923,6690,1880,95741,92375,477,81916,9982,3366
2100,"Haines Borough, Alaska",0,0,0,0,0,0,1975,1883,19,1719,145,92,2467,2351,32,2050,269,116
2105,"Hoonah-Angoon Census Area, Alaska",15,15,0,10,5,0,873,805,1,711,93,68,1991,1777,5,1514,258,214
2110,"Juneau City and Borough, Alaska",324,316,0,313,3,8,20887,20386,178,19401,807,501,31748,30742,193,28781,1768,1006
2122,"Kenai Peninsula Borough, Alaska",216,186,46,119,21,30,45880,42827,520,37440,4867,3053,56187,52267,717,45227,6323,3920
2130,"Ketchikan Gateway Borough, Alaska",58,58,12,46,0,0,8719,8339,18,7783,538,380,13449,12683,58,11521,1104,766
2150,"Kodiak Island Borough, Alaska",23,23,0,23,0,0,6768,6482,0,6140,342,286,13445,12634,18,11568,1048,811
2158,"Kusilvak Census Area, Alaska",19,19,0,14,5,0,183,155,0,103,52,28,7915,6511,0,5081,1430,1404
2164,"Lake and Peninsula Borough, Alaska",1,1,0,1,0,0,227,214,0,193,21,13,1206,1055,3,807,245,151
2170,"Matanuska-Susitna Borough, Alaska",1035,1024,0,1012,12,11,79858,76724,446,71058,5220,3134,99270,95528,511,88679,6338,3742
2180,"Nome Census Area, Alaska",66,66,0,66,0,0,1231,1204,0,1092,112,27,9419,8488,2,6708,1778,931
2185,"North Slope Borough, Alaska",19,18,0,15,3,1,627,605,0,579,26,22,6704,6100,34,5101,965,604
2188,"Northwest Arctic Borough, Alaska",17,17,0,17,0,0,715,681,0,643,38,34,7422,6268,0,5282,986,1154
2195,"Petersburg Borough, Alaska",18,18,0,14,4,0,2143,2037,4,1884,149,106,3172,2993,6,2498,489,179
2198,"Prince of Wales-Hyder Census Area, Alaska",9,9,0,9,0,0,2857,2614,8,2179,427,243,6369,5775,13,4630,1132,594
2220,"Sitka City and Borough, Alaska",56,51,0,51,0,5,5339,5175,42,4800,333,164,8514,8161,51,7319,791,353
2230,"Skagway Municipality, Alaska",9,9,0,7,2,0,726,703,1,624,78,23,902,878,1,779,98,24
2240,"Southeast Fairbanks Census Area, Alaska",111,110,0,102,8,1,4866,4701,5,4107,589,165,6507,6002,19,5189,794,505
2261,"Valdez-Cordova Census Area, Alaska",9,9,0,9,0,0,6472,6271,70,5785,416,201,9176,8670,89,8000,581,506
2275,"Wrangell City and Borough, Alaska",4,4,0,4,0,0,1571,1404,16,1258,130,167,2426,2172,23,1923,226,254
2282,"Yakutat City and Borough, Alaska",2,2,0,0,2,0,250,228,3,191,34,22,613,578,9,452,117,35
2290,"Yukon-Koyukuk Census Area, Alaska",4,4,0,4,0,0,977,860,2,717,141,117,5218,3953,19,2678,1256,1265
4001,"Apache County, Arizona",280,260,0,106,154,20,12630,11667,179,10101,1387,963,70199,41094,823,27465,12806,29105
4003,"Cochise County, Arizona",3482,3280,0,2924,356,202,66139,60134,351,55033,4750,6005,116239,104500,472,93860,10168,11739
4005,"Coconino County, Arizona",1225,1096,3,957,136,129,67298,64651,217,59803,4631,2647,125977,111668,566,95770,15332,14309
4007,"Gila County, Arizona",220,56,0,56,0,164,32904,28789,194,23932,4663,4115,52154,43061,236,32840,9985,9093
4009,"Graham County, Arizona",234,193,0,151,42,41,17896,16668,15,14643,2010,1228,33331,29555,101,25019,4435,3776
4011,"Greenlee County, Arizona",191,191,0,166,25,0,4410,4133,0,3657,476,277,9278,8645,0,7640,1005,633
4012,"La Paz County, Arizona",169,96,0,70,26,73,11924,9839,169,7797,1873,2085,20239,15815,224,12494,3097,4424
4013,"Maricopa County, Arizona",217494,193440,415,170026,22999,24054,2309573,2192597,8646,2064584,119367,116976,4103358,3769414,13579,3429497,326338,333944
4015,"Mohave County, Arizona",1827,1680,0,1311,369,147,157445,142032,1238,126365,14429,15413,200627,179918,1326,160829,17763,20709
4017,"Navajo County, Arizona",599,538,0,370,168,61,44217,40979,304,37096,3579,3238,105153,79905,889,62720,16296,25248
4019,"Pima County, Arizona",31759,28585,79,25287,3219,3174,515433,485693,3149,450967,31577,29740,978363,909048,4557,826341,78150,69315
4021,"Pinal County, Arizona",15427,14552,49,13579,924,875,225421,208394,861,192000,15533,17027,380293,341973,1736,306607,33630,38320
4023,"Santa Cruz County, Arizona",163,140,0,103,37,23,6838,6093,132,5295,666,745,45956,39326,256,33921,5149,6630
4025,"Yavapai County, Arizona",1022,963,8,935,20,59,175559,162333,1096,146663,14574,13226,216335,199272,1163,177562,20547,17063
4027,"Yuma County, Arizona",3642,3246,8,3000,238,396,62757,56275,371,51840,4064,6482,198622,170511,1909,154909,13693,28111
5001,"Arkansas County, Arkansas",4767,4029,0,2991,1038,738,12716,10866,104,8434,2328,1850,18091,15420,104,11924,3392,2671
5003,"Ashley County, Arkansas",5257,3855,19,2640,1196,1402,14012,12314,79,9946,2289,1698,20578,17264,98,13485,3681,3314
5005,"Baxter County, Arkansas",37,37,0,37,0,0,38648,33696,521,28668,4507,4952,40618,35407,541,30268,4598,5211
5007,"Benton County, Arkansas",3938,3761,0,2045,1716,177,184631,172822,554,117151,55117,11809,249043,232287,635,146958,84694,16756
5009,"Boone County, Arkansas",99,93,0,93,0,6,34628,29993,290,27063,2640,4635,36697,31912,290,28819,2803,4785
5011,"Bradley County, Arkansas",3169,2289,38,1580,671,880,6013,5097,14,4437,646,916,10796,8624,52,6662,1910,2172
5013,"Calhoun County, Arkansas",1127,750,0,495,255,377,3683,2949,102,2246,601,734,5051,3926,102,2930,894,1125
5015,"Carroll County, Arkansas",318,195,0,195,0,123,22182,19232,543,15177,3512,2950,27505,23718,624,18459,4635,3787
5017,"Chicot County, Arkansas",5690,4152,9,3271,872,1538,3893,3420,73,2954,393,473,10294,8020,82,6546,1392,2274
5019,"Clark County, Arkansas",4741,3567,0,2954,613,1174,13474,11560,31,9340,2189,1914,19674,16235,101,13234,2900,3439
5021,"Clay County, Arkansas",75,75,0,75,0,0,14445,11707,48,9530,2129,2738,15054,12261,48,10014,2199,2793
5023,"Cleburne County, Arkansas",127,127,0,80,47,0,23730,20550,104,17810,2636,3180,25015,21656,111,18812,2733,3359
5025,"Cleveland County, Arkansas",905,532,0,298,234,373,6977,6143,117,4293,1733,834,8238,6939,117,4814,2008,1299
5027,"Columbia County, Arkansas",7694,5304,0,4034,1270,2390,13307,11336,119,9715,1502,1971,22238,17712,119,14606,2987,4526
5029,"Conway County, Arkansas",2321,1841,74,1333,434,480,16944,14040,76,10495,3469,2904,20725,17132,150,12583,4399,3593
5031,"Craighead County, Arkansas",13360,11939,0,10118,1821,1421,77767,71643,96,64913,6634,6124,100505,92493,154,82266,10073,8012
5033,"Crawford County, Arkansas",760,682,0,520,162,78,52295,45774,588,38839,6347,6521,61494,54045,677,45373,7995,7449
5035,"Crittenden County, Arkansas",23797,18407,30,15420,2957,5390,20945,18783,77,16675,2031,2162,48571,40638,107,35082,5449,7933
5037,"Cross County, Arkansas",3851,2830,25,2529,276,1021,12365,10147,18,8503,1626,2218,16940,13659,43,11674,1942,3281
5039,"Dallas County, Arkansas",2848,2179,0,1537,642,669,3708,3218,31,2459,728,490,6951,5610,31,4195,1384,1341
5041,"Desha County, Arkansas",5734,4582,21,2746,1815,1152,5456,4608,121,3451,1036,848,12007,9786,142,6431,3213,2221
5043,"Drew County, Arkansas",4939,3914,0,3116,798,1025,11940,10400,187,8739,1474,1540,17602,14972,212,12452,2308,2630
5045,"Faulkner County, Arkansas",12899,11754,42,9804,1908,1145,94548,87883,783,76293,10807,6665,116500,107990,880,92527,14583,8510
5047,"Franklin County, Arkansas",86,47,0,45,2,39,16224,13094,255,9666,3173,3130,17475,13907,255,10381,3271,3568
5049,"Fulton County, Arkansas",36,36,0,36,0,0,11378,9777,0,7391,2386,1601,11910,10261,0,7768,2493,1649
5051,"Garland County, Arkansas",7508,6031,58,4333,1640,1477,79374,71814,706,62922,8186,7560,95793,85750,819,74051,10880,10043
5053,"Grant County, Arkansas",485,475,14,426,35,10,16706,15308,58,12337,2913,1398,17921,16457,80,13300,3077,1464
5055,"Greene County, Arkansas",378,368,0,186,182,10,40926,36715,173,31840,4702,4211,43518,39181,188,33904,5089,4337
5057,"Hempstead County, Arkansas",6443,4954,20,3854,1080,1489,12010,9676,96,8375,1205,2334,21809,17152,116,14509,2527,4657
5059,"Hot Spring County, Arkansas",3136,2761,24,2154,583,375,26326,22903,330,17768,4805,3423,31439,27349,389,21409,5551,4090
5061,"Howard County, Arkansas",2785,2057,28,1391,638,728,8588,7498,71,6137,1290,1090,13285,11206,99,8799,2308,2079
5063,"Independence County, Arkansas",622,593,0,442,151,29,32171,27750,465,21958,5327,4421,36026,30750,603,24046,6101,5276
5065,"Izard County, Arkansas",0,0,0,0,0,0,12046,10558,129,7338,3091,1488,12614,11116,134,7708,3274,1498
5067,"Jackson County, Arkansas",2133,1852,13,1434,405,281,11266,8587,58,6929,1600,2679,14304,11201,71,9115,2015,3103
5069,"Jefferson County, Arkansas",37040,31103,301,19282,11520,5937,25779,22745,295,18515,3935,3034,65557,56135,596,39399,16140,9422
5071,"Johnson County, Arkansas",379,324,0,219,105,55,20497,16979,137,13851,2991,3518,25378,20562,137,15990,4435,4816
5073,"Lafayette County, Arkansas",2638,1546,8,983,555,1092,4084,3221,69,2746,406,863,6918,4926,77,3832,1017,1992
5075,"Lawrence County, Arkansas",44,20,0,20,0,24,15630,12978,119,10699,2160,2652,16200,13444,119,11056,2269,2756
5077,"Lee County, Arkansas",4642,3138,7,1960,1171,1504,3137,2483,91,1960,432,654,7983,5797,99,4084,1614,2186
5079,"Lincoln County, Arkansas",2053,1706,16,1183,507,347,6647,5411,97,4335,979,1236,9086,7402,113,5717,1572,1684
5081,"Little River County, Arkansas",2520,1739,52,1426,261,781,9024,8007,175,6457,1375,1017,12333,10443,229,8519,1695,1890
5083,"Logan County, Arkansas",388,388,0,159,229,0,19286,16450,155,14097,2198,2836,21188,18239,155,15381,2703,2949
5085,"Lonoke County, Arkansas",4213,3258,8,2268,982,955,61426,55135,277,48810,6048,6291,70933,63438,317,55503,7618,7495
5087,"Madison County, Arkansas",83,13,0,13,0,70,14267,11811,351,9038,2422,2456,15824,12856,417,9830,2609,2968
5089,"Marion County, Arkansas",19,19,0,19,0,0,15341,13026,115,11365,1546,2315,16205,13830,149,11909,1772,2375
5091,"Miller County, Arkansas",10458,8727,46,6646,2035,1731,29520,26488,278,23437,2773,3032,42445,37512,324,32115,5073,4933
5093,"Mississippi County, Arkansas",15083,12374,43,9876,2455,2709,25015,21585,132,17440,4013,3430,42723,36120,175,28956,6989,6603
5095,"Monroe County, Arkansas",2993,1981,13,1423,545,1012,3993,3312,26,2382,904,681,7346,5560,39,4062,1459,1786
5097,"Montgomery County, Arkansas",0,0,0,0,0,0,8128,6516,47,5045,1424,1612,8922,7182,47,5657,1478,1740
5099,"Nevada County, Arkansas",2825,1615,44,1163,408,1210,5251,4094,272,2686,1136,1157,8342,5963,316,4094,1553,2379
5101,"Newton County, Arkansas",0,0,0,0,0,0,7387,6108,199,4868,1041,1279,7835,6469,199,5163,1107,1366
5103,"Ouachita County, Arkansas",9843,6247,91,4594,1562,3596,13291,11186,305,9148,1733,2105,23990,18117,396,14209,3512,5873
5105,"Perry County, Arkansas",209,209,0,209,0,0,9399,8000,75,6275,1650,1399,10130,8680,75,6816,1789,1450
5107,"Phillips County, Arkansas",12166,8789,20,6549,2220,3377,6632,5299,9,4835,455,1333,19314,14523,29,11767,2727,4791
5109,"Pike County, Arkansas",274,134,0,105,29,140,9384,7788,39,6122,1627,1596,10700,8783,110,6862,1811,1917
5111,"Poinsett County, Arkansas",1304,1089,3,871,215,215,20764,17359,89,14622,2648,3405,23752,19937,92,16757,3088,3815
5113,"Polk County, Arkansas",86,86,7,48,31,0,17686,14817,443,11123,3251,2869,20086,16990,450,12899,3641,3096
5115,"Pope County, Arkansas",1310,1140,0,798,342,170,50999,45000,383,37736,6881,5999,59872,52830,392,43529,8909,7042
5117,"Prairie County, Arkansas",1087,798,2,433,363,289,6956,5608,36,4067,1505,1348,8175,6472,38,4560,1874,1703
5119,"Pulaski County, Arkansas",139226,115134,826,91652,22656,24092,205608,188959,1327,171681,15951,16649,386477,341542,2220,295917,43405,44935
5121,"Randolph County, Arkansas",114,114,0,96,18,0,16353,13059,178,10936,1945,3294,17119,13641,178,11429,2034,3478
5123,"St. Francis County, Arkansas",13193,9779,13,6657,3109,3414,9421,7150,52,5164,1934,2271,23203,17459,65,12158,5236,5744
5125,"Saline County, Arkansas",7201,6459,18,5832,609,742,98786,91142,437,81307,9398,7644,114937,105980,524,94602,10854,8957
5127,"Scott County, Arkansas",18,6,0,6,0,12,8880,7055,58,5423,1574,1825,10518,8461,58,6251,2152,2057
5129,"Searcy County, Arkansas",0,0,0,0,0,0,7333,5931,202,4352,1377,1402,7837,6331,202,4677,1452,1506
5131,"Sebastian County, Arkansas",8342,6157,0,4843,1314,2185,88355,76741,276,67648,8817,11614,125601,107343,383,92795,14165,18258
5133,"Sevier County, Arkansas",822,675,0,525,150,147,9915,8312,179,6821,1312,1603,17064,14417,254,12237,1926,2647
5135,"Sharp County, Arkansas",67,39,0,39,0,28,15810,13167,88,9878,3201,2643,16820,14086,88,10702,3296,2734
5137,"Stone County, Arkansas",0,0,0,0,0,0,11683,9495,265,6501,2729,2188,12300,9899,265,6750,2884,2401
5139,"Union County, Arkansas",12953,7061,57,5410,1594,5892,24107,20520,49,17736,2735,3587,39532,29676,106,25123,4447,9856
5141,"Van Buren County, Arkansas",68,68,15,46,7,0,15513,13068,155,9656,3257,2445,16553,13963,170,10284,3509,2590
5143,"Washington County, Arkansas",6723,6390,0,4542,1848,333,154814,144095,1369,124887,17839,10719,215904,200662,1462,167198,32002,15242
5145,"White County, Arkansas",2898,2531,0,1837,694,367,66191,58219,273,50675,7271,7972,74809,66151,340,57253,8558,8658
5147,"Woodruff County, Arkansas",1829,1003,44,858,101,826,4592,3440,3,2859,578,1152,6646,4635,47,3899,689,2011
5149,"Yell County, Arkansas",488,407,0,345,62,81,16035,13408,221,11312,1875,2627,21260,17011,221,13962,2828,4249
6001,"Alameda County, California",174749,157110,829,136771,19510,17639,512675,493766,1607,471534,20625,18909,1596831,1519542,4621,1418253,96668,77289
6003,"Alpine County, California",10,10,0,10,0,0,761,740,0,732,8,21,1167,1116,0,1067,49,51
6005,"Amador County, California",14,14,0,14,0,0,28129,25726,233,23470,2023,2403,33562,30660,241,27803,2616,2902
6007,"Butte County, California",2976,2735,0,2358,377,241,160368,149537,1193,137487,10857,10831,219276,205188,1752,187027,16409,14088
6009,"Calaveras County, California",210,210,0,210,0,0,36663,32313,890,29023,2400,4350,44544,39406,940,35406,3060,5138
6011,"Colusa County, California",162,150,0,133,17,12,7712,6881,114,6392,375,831,21267,18116,190,16540,1386,3151
6013,"Contra Costa County, California",94470,87656,196,78660,8800,6814,499729,482088,1757,463628,16703,17641,1113496,1068634,3536,1012033,53065,44862
6015,"Del Norte County, California",68,68,0,48,20,0,16705,15044,37,13448,1559,1661,24190,22086,45,19190,2851,2104
6017,"El Dorado County, California",1583,1549,0,1465,84,34,144141,136366,1253,124237,10876,7775,183249,173953,1552,158531,13870,9296
6019,"Fresno County, California",45953,38406,289,32181,5936,7547,287687,266803,1859,246920,18024,20884,954791,850515,6410,745292,98813,104276
6021,"Glenn County, California",141,117,0,115,2,24,14528,12820,117,10529,2174,1708,27625,24186,169,19389,4628,3439
6023,"Humboldt County, California",1169,936,0,781,155,233,99356,91967,409,84504,7054,7389,131341,120715,683,109025,11007,10626
6025,"Imperial County, California",2871,2525,0,2266,259,346,19340,17229,171,16043,1015,2111,170315,152824,1078,130264,21482,17491
6027,"Inyo County, California",78,78,0,73,5,0,11263,10411,111,9253,1047,852,17577,16145,118,14205,1822,1432
6029,"Kern County, California",42091,34811,104,29126,5581,7280,302685,277235,1965,254123,21147,25450,847388,728294,5131,648698,74465,119094
6031,"Kings County, California",6464,5599,0,4662,937,865,45667,42765,307,39422,3036,2902,134591,118784,481,103073,15230,15807
6033,"Lake County, California",1418,1045,0,990,55,373,45405,39546,319,34663,4564,5859,63124,54315,352,47383,6580,8809
6035,"Lassen County, California",264,256,0,252,4,8,18551,16252,316,14520,1416,2299,21483,18771,379,16788,1604,2712
6037,"Los Angeles County, California",798958,699463,3975,600827,94661,99495,2612496,2467859,11319,2334247,122293,144637,9929967,9109430,44311,8183008,882111,820537
6039,"Madera County, California",3558,3069,144,2687,238,489,51407,47235,316,42861,4058,4172,146431,129100,927,108920,19253,17331
6041,"Marin County, California",4628,4289,0,3863,426,339,183009,176448,552,171745,4151,6561,253309,241607,692,231660,9255,11702
6043,"Mariposa County, California",143,134,0,85,49,9,13702,11887,309,10426,1152,1815,16599,14585,328,12691,1566,2014
6045,"Mendocino County, California",392,362,0,296,66,30,56458,50958,900,45641,4417,5500,85320,75528,1158,66269,8101,9792
6047,"Merced County, California",7677,6612,152,5866,594,1065,75781,69511,692,62698,6121,6270,261285,236104,2192,204846,29066,25181
6049,"Modoc County, California",42,42,0,34,8,0,6738,5836,24,5034,778,902,8511,6865,24,5987,854,1646
6051,"Mono County, California",12,12,0,12,0,0,9165,8720,161,7356,1203,445,13734,12146,186,10108,1852,1588
6053,"Monterey County, California",8304,7672,7,6969,696,632,125835,117706,630,111049,6027,8129,415269,360051,2198,327247,30606,55218
6055,"Napa County, California",2539,2509,0,2305,204,30,73029,69300,353,65885,3062,3729,136847,129903,591,121084,8228,6944
6057,"Nevada County, California",451,432,0,429,3,19,83700,78639,828,72665,5146,5061,97633,91800,884,84619,6297,5833
6059,"Orange County, California",51023,48937,28,45519,3390,2086,1283847,1239168,4914,1188316,45938,44679,3112717,2973695,17748,2789548,166399,139022
6061,"Placer County, California",5556,5484,0,5100,384,72,274020,263610,1287,249594,12729,10410,371023,356011,1351,334986,19674,15012
6063,"Plumas County, California",123,123,0,123,0,0,15424,13393,183,11432,1778,2031,18340,16051,210,14009,1832,2289
6065,"Riverside County, California",144600,133234,457,122189,10588,11366,849381,805754,4675,756079,45000,43627,2321272,2166557,9352,1990265,166940,154715
6067,"Sacramento County, California",141057,130588,497,111857,18234,10469,673693,641437,3124,597903,40410,32256,1470605,1392258,6293,1267950,118015,78347
6069,"San Benito County, California",414,414,0,414,0,0,20735,20189,141,19146,902,546,58382,56142,187,52665,3290,2240
6071,"San Bernardino County, California",168687,153249,428,131741,21080,15438,613320,573028,2760,533001,37267,40292,2064557,1914170,7673,1695453,211044,150387
6073,"San Diego County, California",152096,142251,283,130731,11237,9845,1469472,1414527,4475,1356579,53473,54945,3195566,3033476,8764,2849856,174856,162090
6075,"San Francisco County, California",42084,36166,122,30877,5167,5918,345682,332767,1130,319580,12057,12915,843955,795552,2609,749566,43377,48403
6077,"San Joaquin County, California",48432,42043,199,36608,5236,6389,234226,217227,1715,199876,15636,16999,708630,642386,5152,580628,56606,66244
6079,"San Luis Obispo County, California",3214,3071,34,2709,328,143,185819,177362,1203,168206,7953,8457,263819,249277,1872,231901,15504,14542
6081,"San Mateo County, California",17295,15707,50,14027,1630,1588,300657,289577,1002,279277,9298,11080,753412,724420,2203,684464,37753,28992
6083,"Santa Barbara County, California",7254,6956,7,6193,756,298,192431,183699,1067,173357,9275,8732,423159,386475,2553,355919,28003,36684
6085,"Santa Clara County, California",45549,43539,107,39639,3793,2010,607566,589031,2299,565121,21611,18535,1875947,1809658,6499,1717969,85190,66289
6087,"Santa Cruz County, California",1974,1874,0,1780,94,100,153229,147811,584,141412,5815,5418,260833,242377,876,227168,14333,18456
6089,"Shasta County, California",1769,1582,0,1448,134,187,141612,127487,1258,114907,11322,14125,175667,158496,1330,142471,14695,17171
6091,"Sierra County, California",0,0,0,0,0,0,2483,2090,7,1892,191,393,2853,2379,7,2181,191,474
6093,"Siskiyou County, California",607,386,2,364,20,221,33388,30034,403,27353,2278,3354,42971,37966,507,34232,3227,5005
6095,"Solano County, California",57917,53122,128,48176,4818,4795,166148,158385,556,151515,6314,7763,424545,401287,1640,377740,21907,23258
6097,"Sonoma County, California",7294,6956,0,6390,566,338,314424,299615,1954,282236,15425,14809,492515,466027,2215,433737,30075,26488
6099,"Stanislaus County, California",14777,13720,57,12244,1419,1057,228730,210885,1176,194872,14837,17845,530307,486994,2414,443325,41255,43313
6101,"Sutter County, California",1916,1763,0,1475,288,153,44637,41314,192,38086,3036,3323,94571,86922,452,78953,7517,7649
6103,"Tehama County, California",301,296,0,209,87,5,43235,37782,382,32369,5031,5453,62380,53939,412,46250,7277,8441
6105,"Trinity County, California",73,73,0,73,0,0,10696,9338,198,7646,1494,1358,12740,11150,208,9106,1836,1590
6107,"Tulare County, California",6870,6116,0,5145,971,754,132913,118885,1066,107705,10114,14028,453363,383470,3433,323940,56097,69893
6109,"Tuolumne County, California",274,247,0,247,0,27,42341,38065,420,34173,3472,4276,50512,45511,440,40773,4298,5001
6111,"Ventura County, California",13948,13327,47,12175,1105,621,385059,368580,977,354549,13054,16479,835409,777398,1994,721927,53477,58011
6113,"Yolo County, California",4875,4508,0,3805,703,367,98082,93818,461,87561,5796,4264,204411,192269,941,175749,15579,12142
6115,"Yuba County, California",2249,2160,0,1987,173,89,41421,38135,290,34589,3256,3286,73299,68135,467,61476,6192,5164
8001,"Adams County, Colorado",15223,13916,260,11387,2269,1307,246997,236481,1047,219812,15622,10516,483787,452435,2159,397166,53110,31352
8003,"Alamosa County, Colorado",368,231,0,116,115,137,7430,6740,72,5743,925,690,15266,13175,204,10947,2024,2091
8005,"Arapahoe County, Colorado",64858,61359,484,54139,6736,3499,380997,368857,2367,349010,17480,12140,621459,598212,4558,552860,40794,23247
8007,"Archuleta County, Colorado",165,165,0,165,0,0,9536,9058,118,8173,767,478,12427,11307,118,10147,1042,1120
8009,"Baca County, Colorado",55,52,0,15,37,3,2979,2605,11,2295,299,374,3485,3036,11,2646,379,449
8011,"Bent County, Colorado",0,0,0,0,0,0,2532,2189,38,2017,134,343,3833,3337,47,3031,259,496
8013,"Boulder County, Colorado",2497,2431,0,2147,284,66,239388,233792,750,223813,9229,5596,305615,297019,972,279268,16779,8596
8014,"Broomfield County, Colorado",717,706,16,690,0,11,49664,48647,146,46733,1768,1017,63980,62419,162,59824,2433,1561
8015,"Chaffee County, Colorado",69,69,0,69,0,0,15533,14395,135,13043,1217,1138,17584,16114,135,14580,1399,1470
8017,"Cheyenne County, Colorado",0,0,0,0,0,0,1671,1484,9,1372,103,187,2086,1893,9,1781,103,193
8019,"Clear Creek County, Colorado",68,68,0,32,36,0,8248,7886,106,7081,699,362,9137,8703,106,7802,795,434
8021,"Conejos County, Colorado",37,37,0,37,0,0,3551,2944,19,2758,167,607,8088,6239,109,5583,547,1849
8023,"Costilla County, Colorado",13,13,0,13,0,0,1164,990,6,904,80,174,3628,2545,29,2225,291,1083
8025,"Crowley County, Colorado",0,0,0,0,0,0,2998,2735,47,2566,122,263,4277,3886,62,3524,300,391
8027,"Custer County, Colorado",112,112,0,112,0,0,4035,3570,15,3096,459,465,4492,4024,15,3525,484,468
8029,"Delta County, Colorado",172,170,0,163,7,2,24131,21512,271,18841,2400,2619,29045,25491,294,22133,3064,3554
8031,"Denver County, Colorado",62230,54976,83,47334,7559,7254,354488,339563,1628,316918,21017,14925,663513,612927,3211,553055,56661,50586
8033,"Dolores County, Colorado",0,0,0,0,0,0,1585,1418,52,1108,258,167,1736,1552,52,1242,258,184
8035,"Douglas County, Colorado",3725,3715,0,3704,11,10,266846,263443,746,256938,5759,3403,320192,316271,789,308147,7335,3921
8037,"Eagle County, Colorado",458,458,0,401,57,0,36132,35317,179,33373,1765,815,53656,51415,368,46903,4144,2241
8039,"Elbert County, Colorado",154,154,0,154,0,0,21891,21147,98,19965,1084,744,24479,23688,98,22403,1187,791
8041,"El Paso County, Colorado",39890,37680,103,35786,1791,2210,460076,443810,2486,423161,18163,16266,657508,630181,3116,599684,27381,27327
8043,"Fremont County, Colorado",38,17,0,16,1,21,32223,29146,411,25816,2919,3077,35902,32254,411,28593,3250,3648
8045,"Garfield County, Colorado",159,159,0,159,0,0,39142,37442,517,34255,2670,1700,56992,54098,804,48102,5192,2894
8047,"Gilpin County, Colorado",15,15,0,15,0,0,4937,4750,14,4361,375,187,5689,5446,23,4972,451,243
8049,"Grand County, Colorado",39,39,0,39,0,0,12645,11978,34,11504,440,667,14498,13483,34,12806,643,1015
8051,"Gunnison County, Colorado",21,21,0,21,0,0,13478,12856,238,11613,1005,622,15306,14313,238,12978,1097,993
8053,"Hinsdale County, Colorado",0,0,0,0,0,0,743,689,6,543,140,54,817,758,6,579,173,59
8055,"Huerfano County, Colorado",29,0,0,0,0,29,4066,3591,173,3012,406,475,6313,5142,173,4313,656,1171
8057,"Jackson County, Colorado",0,0,0,0,0,0,1019,899,21,774,104,120,1362,1213,21,1081,111,149
8059,"Jefferson County, Colorado",5670,5211,8,4917,286,459,437234,421469,2590,400266,18613,15765,555245,533191,2959,502197,28035,22054
8061,"Kiowa County, Colorado",8,8,0,8,0,0,1175,1064,0,968,96,111,1337,1224,0,1116,108,113
8063,"Kit Carson County, Colorado",13,13,0,13,0,0,5673,5163,22,4701,440,510,7100,6297,24,5744,529,803
8065,"Lake County, Colorado",0,0,0,0,0,0,4693,4286,59,3664,563,407,7330,6550,59,5686,805,780
8067,"La Plata County, Colorado",172,141,0,102,39,31,41963,39405,467,34509,4429,2558,52580,48475,540,41793,6142,4105
8069,"Larimer County, Colorado",2706,2642,0,2495,147,64,268123,259971,1790,242731,15450,8152,321558,310863,2075,288164,20624,10695
8071,"Las Animas County, Colorado",23,23,0,7,16,0,6989,6168,90,5284,794,821,13338,11320,249,9615,1456,2018
8073,"Lincoln County, Colorado",3,1,0,1,0,2,3129,2813,52,2580,181,316,3517,3171,60,2916,195,346
8075,"Logan County, Colorado",124,124,0,121,3,0,16453,14840,151,13610,1079,1613,20789,18726,151,17256,1319,2063
8077,"Mesa County, Colorado",875,844,11,811,22,31,119182,111291,1036,104238,6017,7891,145204,134996,1084,126254,7658,10208
8079,"Mineral County, Colorado",13,13,0,13,0,0,687,625,7,565,53,62,811,749,7,689,53,62
8081,"Moffat County, Colorado",120,120,0,120,0,0,10539,9599,65,8725,809,940,12908,11585,65,10411,1109,1323
8083,"Montezuma County, Colorado",63,63,0,55,8,0,18666,16898,109,14408,2381,1768,25515,22520,259,18250,4011,2995
8085,"Montrose County, Colorado",141,115,0,88,27,26,30761,27065,346,24494,2225,3696,40376,34738,361,30419,3958,5638
8087,"Morgan County, Colorado",853,640,0,434,206,213,16395,14697,100,13450,1147,1698,27725,23816,181,21401,2234,3909
8089,"Otero County, Colorado",92,88,0,36,52,4,9624,8493,23,7818,652,1131,17826,15823,35,13929,1859,2003
8091,"Ouray County, Colorado",0,0,0,0,0,0,4303,4063,37,3682,344,240,4653,4402,37,3987,378,251
8093,"Park County, Colorado",33,33,0,25,8,0,15073,14209,57,12807,1345,864,16790,15856,57,14423,1376,934
8095,"Phillips County, Colorado",12,12,0,12,0,0,3276,3029,37,2785,207,247,4253,3959,37,3490,432,294
8097,"Pitkin County, Colorado",235,212,87,125,0,23,15160,14852,265,13934,653,308,17623,16967,402,15693,872,656
8099,"Prowers County, Colorado",7,7,0,0,7,0,7005,6225,0,5772,453,780,11701,10406,10,9632,764,1295
8101,"Pueblo County, Colorado",3058,2587,0,2227,360,471,83157,76773,928,67758,8087,6384,158805,142268,1332,120109,20827,16537
8103,"Rio Blanco County, Colorado",0,0,0,0,0,0,5526,5099,22,4545,532,427,6221,5677,27,4930,720,544
8105,"Rio Grande County, Colorado",63,63,0,39,24,0,5825,5174,114,4620,440,651,11219,9366,117,8271,978,1853
8107,"Routt County, Colorado",135,130,0,130,0,5,21601,20788,68,19797,923,813,23963,22928,68,21769,1091,1035
8109,"Saguache County, Colorado",0,0,0,0,0,0,3685,3295,20,2648,627,390,6320,5460,32,4433,995,860
8111,"San Juan County, Colorado",0,0,0,0,0,0,490,475,15,450,10,15,569,532,15,497,20,37
8113,"San Miguel County, Colorado",13,13,0,13,0,0,6761,6563,69,5737,757,198,7778,7473,69,6483,921,305
8115,"Sedgwick County, Colorado",30,30,0,30,0,0,1909,1686,32,1427,227,223,2315,2035,44,1703,288,280
8117,"Summit County, Colorado",248,219,0,219,0,29,24079,23131,72,20527,2532,948,29328,28087,221,24547,3319,1241
8119,"Teller County, Colorado",153,153,11,142,0,0,21171,20334,176,19248,910,837,23622,22632,187,21355,1090,990
8121,"Washington County, Colorado",19,19,0,19,0,0,4044,3623,92,3226,305,421,4521,4096,92,3600,404,425
8123,"Weld County, Colorado",2808,2693,0,2342,351,115,185497,177137,1124,163598,12415,8360,279413,262111,1769,236617,23725,17302
8125,"Yuma County, Colorado",149,149,0,149,0,0,7556,6641,72,5905,664,915,9991,8590,72,7439,1079,1401
9001,"Fairfield County, Connecticut",103835,95745,42,85948,9755,8090,583678,555080,2103,534298,18679,28598,928997,879127,2490,831638,44999,49870
9003,"Hartford County, Connecticut",115736,103034,161,90920,11953,12702,545584,506388,2706,482615,21067,39196,871283,802479,3385,744544,54550,68804
9005,"Litchfield County, Connecticut",3343,2791,0,2525,266,552,162452,151342,1123,142810,7409,11110,181327,169222,1142,159870,8210,12105
9007,"Middlesex County, Connecticut",7893,7190,0,6824,366,703,134259,125753,659,119045,6049,8506,158209,148147,690,140044,7413,10062
9009,"New Haven County, Connecticut",107703,94014,438,83997,9579,13689,534474,492428,2248,463616,26564,42046,833338,759667,3988,701478,54201,73671
9011,"New London County, Connecticut",13860,12674,23,11502,1149,1186,197947,184526,770,175725,8031,13421,258290,240698,857,227776,12065,17592
9013,"Tolland County, Connecticut",3183,2812,9,2308,495,371,118595,112907,779,107051,5077,5688,135678,129248,807,121808,6633,6430
9015,"Windham County, Connecticut",1901,1619,0,1488,131,282,93638,86475,368,80031,6076,7163,111329,102530,671,93641,8218,8799
10001,"Kent County, Delaware",39739,37299,88,32755,4456,2440,107083,98504,580,90256,7668,8579,167914,155698,745,141341,13612,12216
10003,"New Castle County, Delaware",131609,116361,411,101840,14110,15248,314666,295798,1194,277642,16962,18868,538009,497321,1994,454226,41101,40688
10005,"Sussex County, Delaware",25755,20879,29,15995,4855,4876,159514,145778,1038,131976,12764,13736,212702,190684,1261,166307,23116,22018
11001,"District of Columbia, District of Columbia",302498,255111,1345,198726,55040,47387,226295,222800,411,216344,6045,3495,632449,573669,1979,500358,71332,58780
12001,"Alachua County, Florida",49427,40758,192,34720,5846,8669,151421,141941,947,132442,8552,9480,243348,222814,1245,204560,17009,20534
12003,"Baker County, Florida",2593,2182,0,1973,209,411,21397,19189,255,16209,2725,2208,25066,22389,255,18981,3153,2677
12005,"Bay County, Florida",19279,15979,88,14104,1787,3300,137642,127182,627,116927,9628,10460,177820,162831,736,149083,13012,14989
12007,"Bradford County, Florida",3552,1885,0,1515,370,1667,18613,15250,244,13972,1034,3363,23427,17968,244,16266,1458,5459
12009,"Brevard County, Florida",56785,48790,299,41525,6966,7995,423475,397275,1625,372556,23094,26200,562236,524484,2152,486914,35418,37752
12011,"Broward County, Florida",530693,485746,860,409793,75093,44947,713418,667183,3020,618629,45534,46235,1873506,1753134,6873,1582832,163429,120372
12013,"Calhoun County, Florida",1046,791,0,423,368,255,10305,8489,94,7167,1228,1816,12442,10297,94,8229,1974,2145
12015,"Charlotte County, Florida",8830,7784,0,6888,896,1046,143999,132782,1251,121944,9587,11217,169562,156558,1267,143187,12104,13004
12017,"Citrus County, Florida",3729,3322,42,2785,495,407,123531,112175,703,102465,9007,11356,138903,126306,776,114999,10531,12597
12019,"Clay County, Florida",20023,18791,49,17512,1230,1232,149774,143184,1109,132022,10053,6590,201943,193197,1483,179198,12516,8746
12021,"Collier County, Florida",24603,20700,10,16504,4186,3903,224555,213220,1611,194715,16894,11335,352516,326944,1755,289380,35809,25572
12023,"Columbia County, Florida",10194,8277,45,6431,1801,1917,48090,44240,315,38930,4995,3850,63645,57082,365,49539,7178,6563
12027,"DeSoto County, Florida",3306,1410,17,833,560,1896,18506,14128,180,12256,1692,4378,32027,19892,305,15756,3831,12135
12029,"Dixie County, Florida",608,373,0,169,204,235,13176,10375,329,6388,3658,2801,14781,11523,333,7052,4138,3258
12031,"Duval County, Florida",264861,227321,890,189157,37274,37540,482076,447772,1933,415747,30092,34304,892235,809974,3349,727914,78711,82261
12033,"Escambia County, Florida",63490,53664,215,44757,8692,9826,190486,178595,460,166881,11254,11891,291488,267941,725,243697,23519,23547
12035,"Flagler County, Florida",10689,9305,53,7811,1441,1384,78147,72891,440,63895,8556,5256,104521,96802,524,84005,12273,7719
12037,"Franklin County, Florida",795,668,90,505,73,127,8545,7104,66,6301,737,1441,9964,8341,156,7337,848,1623
12039,"Gadsden County, Florida",24221,17228,141,12730,4357,6993,12996,11219,44,10060,1115,1777,42251,32603,185,26067,6351,9648
12041,"Gilchrist County, Florida",317,284,0,182,102,33,14636,12444,44,9852,2548,2192,15881,13278,44,10411,2823,2603
12043,"Glades County, Florida",1281,858,0,562,296,423,7593,5894,157,4645,1092,1699,11783,8741,190,6549,2002,3042
12045,"Gulf County, Florida",1742,1440,45,1298,97,302,11141,9731,114,9081,536,1410,13635,11860,159,11031,670,1775
12047,"Hamilton County, Florida",3104,2513,11,1948,554,591,6785,6081,245,5180,656,704,10867,9046,274,7361,1411,1821
12049,"Hardee County, Florida",1436,509,0,479,30,927,12148,9814,220,8044,1550,2334,25130,17332,484,13599,3249,7798
12051,"Hendry County, Florida",4151,2848,0,2071,777,1303,12613,10595,79,9458,1058,2018,37160,29916,136,24961,4819,7244
12053,"Hernando County, Florida",8933,7971,23,7057,891,962,140557,128923,977,116460,11486,11634,177033,162656,1076,147568,14012,14377
12055,"Highlands County, Florida",9119,7558,45,6299,1214,1561,67508,57019,933,50656,5430,10489,98389,81249,1204,69786,10259,17140
12057,"Hillsborough County, Florida",219870,196210,812,168796,26602,23660,667676,633283,1969,595033,36281,34393,1330193,1232883,3497,1129693,99693,97310
12059,"Holmes County, Florida",545,446,11,329,106,99,16207,12586,140,10975,1471,3621,17648,13808,155,12035,1618,3840
12061,"Indian River County, Florida",13109,10088,0,8349,1739,3021,111456,101639,830,94729,6080,9817,146417,131014,1090,120614,9310,15403
12063,"Jackson County, Florida",9829,6747,15,6165,567,3082,28664,24003,128,21102,2773,4661,40722,32604,185,28735,3684,8118
12065,"Jefferson County, Florida",3762,2982,0,2581,401,780,7269,6556,150,5624,782,713,11547,9994,150,8534,1310,1553
12067,"Lafayette County, Florida",669,521,0,257,264,148,5357,4668,92,4322,254,689,7107,6037,92,5353,592,1070
12069,"Lake County, Florida",32246,28387,116,23548,4723,3859,229799,211772,1870,194231,15671,18027,322408,296278,2133,268158,25987,26130
12071,"Lee County, Florida",58512,51057,241,40231,10585,7455,472762,445297,5273,403612,36412,27465,689622,635594,6974,562435,66185,54028
12073,"Leon County, Florida",83674,76765,166,64359,12240,6909,157200,152207,857,142011,9339,4993,272110,259717,1098,234678,23941,12393
12075,"Levy County, Florida",3385,2456,0,1318,1138,929,31614,27417,352,20854,6211,4197,39293,33710,388,24950,8372,5583
12077,"Liberty County, Florida",837,780,0,510,270,57,5768,4949,151,3895,903,819,6876,5918,151,4594,1173,958
12079,"Madison County, Florida",6190,4186,3,2960,1223,2004,9326,7784,183,6389,1212,1542,16457,12738,186,10036,2516,3719
12081,"Manatee County, Florida",31150,26922,0,21547,5375,4228,258981,241519,926,213933,26660,17462,359212,331519,1015,285573,44931,27693
12083,"Marion County, Florida",41284,33543,668,28534,4341,7741,240019,214638,2404,194853,17381,25381,334504,294224,3630,264594,26000,40280
12085,"Martin County, Florida",7389,6592,0,6122,470,797,120934,113398,273,104970,8155,7536,151860,140741,458,128602,11681,11119
12086,"Miami-Dade County, Florida",468824,397423,1190,308592,87641,71401,358163,340393,1704,311237,27452,17770,2654763,2389040,10132,2079807,299101,265723
12087,"Monroe County, Florida",5086,4388,0,3704,684,698,50336,47339,89,42547,4703,2997,74483,68530,89,60868,7573,5953
12089,"Nassau County, Florida",4758,4084,32,3277,775,674,68085,64124,946,57914,5264,3961,77670,72845,1008,65253,6584,4825
12091,"Okaloosa County, Florida",17616,15785,19,13459,2307,1831,144091,134773,538,122030,12205,9318,191934,178835,644,161078,17113,13099
12093,"Okeechobee County, Florida",2077,1600,48,1398,154,477,25122,21067,155,16549,4363,4055,37255,29180,369,22127,6684,8075
12095,"Orange County, Florida",263816,240843,295,211563,28985,22973,517094,493450,1809,467051,24590,23644,1257883,1183970,3226,1080746,99998,73913
12097,"Osceola County, Florida",35862,28762,445,24777,3540,7100,109929,96895,501,87550,8844,13034,323016,271571,2328,239435,29808,51445
12099,"Palm Beach County, Florida",258528,223419,1033,187890,34496,35109,788471,739512,3469,693940,42103,48959,1406882,1294073,6118,1171767,116188,112809
12101,"Pasco County, Florida",26098,23784,154,20559,3071,2314,375046,341418,1687,309148,30583,33628,490704,448760,2042,406213,40505,41944
12103,"Pinellas County, Florida",94172,74475,593,60916,12966,19697,697076,636962,2505,591445,43012,60114,932629,841620,3463,768422,69735,91009
12105,"Polk County, Florida",95823,73707,439,46738,26530,22116,389882,351038,2319,281519,67200,38844,639214,551025,3145,416637,131243,88189
12107,"Putnam County, Florida",11330,7906,68,5416,2422,3424,51057,43343,551,37252,5540,7714,70917,57862,627,48085,9150,13055
12109,"St. Johns County, Florida",11078,9365,259,7861,1245,1713,187768,179159,961,166512,11686,8609,224071,212381,1228,196514,14639,11690
12111,"St. Lucie County, Florida",57606,50183,54,43512,6617,7423,173517,160244,1474,148924,9846,13273,295750,268442,2055,245144,21243,27308
12113,"Santa Rosa County, Florida",7023,6631,116,6130,385,392,135583,129681,656,119922,9103,5902,160379,153182,772,140905,11505,7197
12115,"Sarasota County, Florida",17584,15078,9,13294,1775,2506,333539,309972,1298,287017,21657,23567,399102,370391,1323,341115,27953,28711
12117,"Seminole County, Florida",51109,47783,12,44109,3662,3326,277021,268342,1023,257278,10041,8679,445324,428931,1400,406274,21257,16393
12119,"Sumter County, Florida",4683,2869,218,1895,756,1814,96246,90066,1195,82117,6754,6180,107410,98749,1750,88600,8399,8661
12121,"Suwannee County, Florida",5470,4963,0,4065,898,507,32249,28540,92,26602,1846,3709,42243,37041,230,33678,3133,5202
12123,"Taylor County, Florida",2882,2331,97,1386,848,551,14726,12900,255,10537,2108,1826,18367,15949,352,12488,3109,2418
12125,"Union County, Florida",1252,815,0,632,183,437,8046,6622,270,5423,929,1424,9972,7937,270,6482,1185,2035
12127,"Volusia County, Florida",51846,44806,61,34049,10696,7040,372634,345539,2004,305059,38476,27095,508859,468867,2214,405607,61046,39992
12129,"Wakulla County, Florida",2933,2777,0,1955,822,156,23759,22164,201,18873,3090,1595,28043,26171,201,21923,4047,1872
12131,"Walton County, Florida",2371,2116,0,1787,329,255,52413,48023,235,42169,5619,4390,61420,55963,235,49041,6687,5457
12133,"Washington County, Florida",2664,2454,0,1915,539,210,18081,15235,245,12894,2096,2846,21973,18786,245,15893,2648,3187
13001,"Appling County, Georgia",3076,2036,19,987,1030,1040,12570,10611,241,7336,3034,1959,17944,14786,260,9368,5158,3158
13003,"Atkinson County, Georgia",1478,970,0,840,130,508,4695,3926,191,2782,953,769,8278,6571,193,4737,1641,1707
13005,"Bacon County, Georgia",1384,1170,0,696,474,214,7971,7126,170,5852,1104,845,10632,9325,170,6939,2216,1307
13007,"Baker County, Georgia",1347,856,0,431,425,491,1694,1281,11,1141,129,413,3248,2282,11,1682,589,966
13009,"Baldwin County, Georgia",17271,12936,90,10443,2403,4335,21737,19554,121,17689,1744,2183,41440,34584,219,30053,4312,6856
13011,"Banks County, Georgia",467,317,3,170,144,150,16225,13169,315,11020,1834,3056,18363,14951,318,12545,2088,3412
13013,"Barrow County, Georgia",8323,7492,68,6069,1355,831,54663,50307,266,45684,4357,4356,74856,69209,540,61587,7082,5647
13015,"Bartow County, Georgia",10808,10182,152,8840,1190,626,79665,72819,490,66100,6229,6846,101734,92344,832,83004,8508,9390
13017,"Ben Hill County, Georgia",6160,4699,13,3844,842,1461,9534,7429,31,6318,1080,2105,16949,13307,44,11051,2212,3642
13019,"Berrien County, Georgia",2203,1797,16,1571,210,406,15526,13270,119,10488,2663,2256,18833,16015,135,12863,3017,2818
13021,"Bibb County, Georgia",80407,65827,244,50406,15177,14580,57776,52262,337,47018,4907,5514,147595,126536,587,104607,21342,21059
13023,"Bleckley County, Georgia",2552,1777,17,1323,437,775,8329,7210,64,6307,839,1119,11286,9227,81,7870,1276,2059
13025,"Brantley County, Georgia",675,563,0,230,333,112,17010,14614,475,11001,3138,2396,18339,15774,475,11739,3560,2565
13027,"Brooks County, Georgia",5241,4012,13,3374,625,1229,8836,7846,101,7085,660,990,15539,13062,116,11626,1320,2477
13029,"Bryan County, Georgia",5279,4799,64,4315,420,480,25858,24635,170,22856,1609,1223,34795,33029,234,30337,2458,1766
13031,"Bulloch County, Georgia",18254,16482,77,11067,5338,1772,43295,39846,95,34395,5356,3449,66352,60667,211,49145,11311,5685
13033,"Burke County, Georgia",11010,8846,27,6922,1897,2164,10543,9684,85,7537,2062,859,22420,19362,112,15027,4223,3058
13035,"Butts County, Georgia",5136,3426,0,2557,869,1710,14748,13027,47,11145,1835,1721,20907,17438,47,14645,2746,3469
13037,"Calhoun County, Georgia",2866,2150,0,1918,232,716,1484,1197,9,1104,84,287,4642,3637,9,3284,344,1005
13039,"Camden County, Georgia",9584,8558,13,7042,1503,1026,35235,32936,95,30330,2511,2299,50622,47118,178,42715,4225,3504
13043,"Candler County, Georgia",2483,1699,21,1167,511,784,6494,5440,0,4165,1275,1054,10625,8355,21,5938,2396,2270
13045,"Carroll County, Georgia",19616,17736,73,15120,2543,1880,80427,74017,385,66324,7308,6410,111365,102154,471,90051,11632,9211
13047,"Catoosa County, Georgia",1459,1392,0,780,612,67,59779,54674,515,50356,3803,5105,65304,59926,575,54538,4813,5378
13049,"Charlton County, Georgia",3149,2310,0,1690,620,839,7965,6929,405,5639,885,1036,11811,9699,405,7784,1510,2112
13051,"Chatham County, Georgia",107901,94690,309,82097,12284,13211,134841,128030,334,119727,7969,6811,273048,251362,664,228022,22676,21686
13053,"Chattahoochee County, Georgia",1366,1013,0,936,77,353,4921,4568,0,4099,469,353,7647,6884,0,6228,656,763
13055,"Chattooga County, Georgia",1446,1067,0,999,68,379,20068,17048,107,14973,1968,3020,23124,19458,107,17163,2188,3666
13057,"Cherokee County, Georgia",15305,14938,0,14616,322,367,187363,181952,536,175028,6388,5411,234377,225676,536,216995,8145,8701
13059,"Clarke County, Georgia",32294,26930,526,21514,4890,5364,61378,58532,134,54344,4054,2846,113099,101349,660,88760,11929,11750
13061,"Clay County, Georgia",1928,1232,11,1094,127,696,875,756,11,630,115,119,2968,2153,22,1889,242,815
13063,"Clayton County, Georgia",185400,173355,507,145773,27075,12045,30013,26398,170,23507,2721,3615,269618,249282,1043,209073,39166,20336
13065,"Clinch County, Georgia",1827,1198,148,763,287,629,4064,3015,15,2261,739,1049,6307,4307,163,3114,1030,2000
13067,"Cobb County, Georgia",197256,188778,506,171165,17107,8478,386889,373362,857,354875,17630,13527,729418,700217,1696,650507,48014,29201
13069,"Coffee County, Georgia",9725,7460,0,5473,1987,2265,23939,19263,104,16354,2805,4676,39067,31185,166,25411,5608,7882
13071,"Colquitt County, Georgia",10046,8344,0,6971,1373,1702,25605,22532,103,19840,2589,3073,45068,37456,118,32394,4944,7612
13073,"Columbia County, Georgia",23632,22571,0,18448,4123,1061,100437,94946,1309,83933,9704,5491,143225,135756,1309,118636,15811,7469
13075,"Cook County, Georgia",4618,3178,10,2174,994,1440,11065,9413,133,7591,1689,1652,17026,13598,143,10579,2876,3428
13077,"Coweta County, Georgia",24031,20290,28,17307,2955,3741,98460,94320,200,86443,7677,4140,137514,128448,228,116281,11939,9066
13079,"Crawford County, Georgia",2809,2103,16,1636,451,706,9016,8247,142,6770,1335,769,12212,10728,158,8637,1933,1484
13081,"Crisp County, Georgia",9710,6958,0,4934,2024,2752,11468,9845,268,7766,1811,1623,22583,18113,268,13871,3974,4470
13083,"Dade County, Georgia",29,29,0,29,0,0,14146,12454,177,10922,1355,1692,14985,13218,177,11486,1555,1767
13085,"Dawson County, Georgia",196,196,0,196,0,0,21610,20028,21,18303,1704,1582,23219,21548,53,19589,1906,1671
13087,"Decatur County, Georgia",10773,6440,28,5182,1230,4333,13167,10332,82,8931,1319,2835,25778,17975,110,15024,2841,7803
13089,"DeKalb County, Georgia",391904,366242,950,313460,51832,25662,209539,201282,451,191872,8959,8257,723161,676546,1633,598673,76240,46615
13091,"Dodge County, Georgia",4498,2892,0,2239,653,1606,13075,9590,28,8336,1226,3485,18983,13813,28,11549,2236,5170
13093,"Dooly County, Georgia",5801,3737,54,2813,870,2064,5448,4608,60,3866,682,840,12259,9253,114,7385,1754,3006
13095,"Dougherty County, Georgia",59718,49812,59,42241,7512,9906,22939,20331,76,18547,1708,2608,87295,74338,135,64309,9894,12957
13097,"Douglas County, Georgia",62442,60535,0,50204,10331,1907,60135,56158,125,48646,7387,3977,138826,131777,125,112280,19372,7049
13099,"Early County, Georgia",5214,3274,18,2890,366,1940,4737,3629,36,2927,666,1108,10255,7203,54,6105,1044,3052
13101,"Echols County, Georgia",108,108,0,47,61,0,2608,2155,10,1787,358,453,4011,2975,10,2287,678,1036
13103,"Effingham County, Georgia",7466,6725,63,5949,713,741,45098,42473,452,38368,3653,2625,56774,53247,549,47753,4945,3527
13105,"Elbert County, Georgia",5780,3766,0,2939,827,2014,12112,9434,234,7941,1259,2678,19044,13857,234,11242,2381,5187
13107,"Emanuel County, Georgia",7302,4969,0,3541,1428,2333,12997,11211,48,9302,1861,1786,21692,17514,48,13336,4130,4178
13109,"Evans County, Georgia",3018,2327,0,1901,426,691,5823,5205,68,4475,662,618,10250,8501,68,7011,1422,1749
13111,"Fannin County, Georgia",4,4,0,4,0,0,23208,20117,148,18107,1862,3091,24293,21085,148,19040,1897,3208
13113,"Fayette County, Georgia",23075,22093,0,21017,1076,982,70474,67035,193,64587,2255,3439,109749,104668,193,100360,4115,5081
13115,"Floyd County, Georgia",12920,10668,0,9757,911,2252,66087,58660,335,54621,3704,7427,92369,81551,355,75390,5806,10818
13117,"Forsyth County, Georgia",6083,6058,0,5916,142,25,157823,153513,207,147719,5587,4310,210665,204931,294,196513,8124,5734
13119,"Franklin County, Georgia",2024,1383,0,884,499,641,18323,15057,105,12215,2737,3266,21697,17577,152,14046,3379,4120
13121,"Fulton County, Georgia",429231,376925,990,318015,57920,52306,392689,380605,490,363271,16844,12084,975745,901651,1564,813415,86672,74094
13123,"Gilmer County, Georgia",470,216,0,182,34,254,25133,21551,354,19013,2184,3582,29359,24748,354,21719,2675,4611
13125,"Glascock County, Georgia",218,155,0,149,6,63,2606,2182,39,1876,267,424,2939,2452,39,2125,288,487
13127,"Glynn County, Georgia",20965,17397,0,14325,3072,3568,52492,48287,161,44719,3407,4205,82111,73541,161,65795,7585,8570
13129,"Gordon County, Georgia",2134,1537,0,1193,344,597,43650,36567,318,32077,4172,7083,55839,46655,428,40357,5870,9184
13131,"Grady County, Georgia",7141,5892,0,5362,530,1249,14507,12636,61,11142,1433,1871,24869,21380,61,18462,2857,3489
13133,"Greene County, Georgia",5917,4072,41,3239,792,1845,9342,8609,41,7370,1198,733,16536,13594,131,11287,2176,2942
13135,"Gwinnett County, Georgia",235466,228562,240,208499,19823,6904,347108,336153,1120,320633,14400,10955,884911,849199,2119,771814,75266,35712
13137,"Habersham County, Georgia",749,594,0,528,66,155,32153,26177,226,22775,3176,5976,41386,32561,257,27962,4342,8825
13139,"Hall County, Georgia",13811,11914,0,10576,1338,1897,117603,108714,278,100949,7487,8889,190934,171988,492,153747,17749,18946
13141,"Hancock County, Georgia",4335,3189,0,1737,1452,1146,1628,1286,0,1184,102,342,6016,4528,0,2939,1589,1488
13143,"Haralson County, Georgia",1133,1023,0,831,192,110,25969,22739,148,19289,3302,3230,28354,25000,148,21280,3572,3354
13145,"Harris County, Georgia",5131,3941,53,3503,385,1190,25331,23922,408,21690,1824,1409,32675,30067,483,26969,2615,2608
13147,"Hart County, Georgia",4524,3112,0,2098,1014,1412,18713,16039,143,13643,2253,2674,24708,20073,148,16252,3673,4635
13149,"Heard County, Georgia",1089,790,131,442,217,299,9786,8431,21,6886,1524,1355,11458,9781,168,7732,1881,1677
13151,"Henry County, Georgia",89503,87076,120,81433,5523,2427,101207,96217,284,89735,6198,4990,216519,208532,404,193854,14274,7987
13153,"Houston County, Georgia",44372,37188,29,32362,4797,7184,85401,78738,50,71053,7635,6663,148737,133131,79,118613,14439,15606
13155,"Irwin County, Georgia",2471,1762,31,1391,340,709,6107,4919,17,4169,733,1188,8974,6961,48,5840,1073,2013
13157,"Jackson County, Georgia",4237,3662,131,3220,311,575,52082,46659,199,42376,4084,5423,63131,56132,432,50775,4925,6999
13159,"Jasper County, Georgia",2834,2168,0,1643,525,666,10042,9035,63,7381,1591,1007,13640,11814,63,9374,2377,1826
13161,"Jeff Davis County, Georgia",2488,2099,0,1682,417,389,10656,8990,10,6757,2223,1666,14872,12387,10,9076,3301,2485
13163,"Jefferson County, Georgia",8366,5642,37,3620,1985,2724,6419,5797,110,4549,1138,622,15401,11848,147,8285,3416,3553
13165,"Jenkins County, Georgia",3158,2179,0,1146,1033,979,4980,4063,115,3243,705,917,8852,6789,115,4807,1867,2063
13167,"Johnson County, Georgia",3214,2121,60,1372,689,1093,5990,5028,94,4192,742,962,9553,7493,154,5884,1455,2060
13169,"Jones County, Georgia",6989,5764,15,5305,444,1225,20366,18938,78,17142,1718,1428,28261,25569,93,23275,2201,2692
13171,"Lamar County, Georgia",4385,3269,40,2237,992,1116,11659,10584,0,9555,1029,1075,17044,14803,40,12467,2296,2241
13173,"Lanier County, Georgia",2346,1616,0,1082,534,730,7016,5907,10,4687,1210,1109,10088,8190,10,6206,1974,1898
13175,"Laurens County, Georgia",16960,11438,298,8268,2872,5522,27028,21617,108,16871,4638,5411,46347,35273,425,27209,7639,11074
13177,"Lee County, Georgia",5109,4492,3,4037,452,617,20895,19923,26,18532,1365,972,28206,26426,29,24516,1881,1780
13179,"Liberty County, Georgia",24872,22666,365,19034,3267,2206,24088,23166,69,20972,2125,922,60142,56716,452,50154,6110,3426
13181,"Lincoln County, Georgia",2470,1453,11,989,453,1017,5036,4249,0,3609,640,787,7677,5855,11,4730,1114,1822
13183,"Long County, Georgia",4226,3963,3,3589,371,263,10386,9507,52,8517,938,879,17712,16220,55,14474,1691,1492
13185,"Lowndes County, Georgia",39301,32722,190,20761,11771,6579,60677,56774,289,48289,8196,3903,109913,98075,479,76140,21456,11838
13187,"Lumpkin County, Georgia",541,541,0,541,0,0,27449,24302,118,21618,2566,3147,30099,26906,118,23750,3038,3193
13189,"McDuffie County, Georgia",8537,6126,0,4635,1491,2411,11489,9528,74,8248,1206,1961,21165,16260,74,13265,2921,4905
13191,"McIntosh County, Georgia",4901,4100,34,3165,901,801,8654,7932,75,6990,867,722,13983,12427,169,10482,1776,1556
13193,"Macon County, Georgia",6772,4573,4,3331,1238,2199,4009,3578,0,3410,168,431,11788,9002,4,7426,1572,2786
13195,"Madison County, Georgia",2402,1323,4,1258,61,1079,23561,19976,289,16790,2897,3585,28355,23212,296,19597,3319,5143
13197,"Marion County, Georgia",3025,1974,0,926,1048,1051,5013,4230,17,3544,669,783,8472,6558,17,4692,1849,1914
13199,"Meriwether County, Georgia",8042,5578,188,3773,1617,2464,11742,9290,264,7291,1735,2452,20874,15757,452,11821,3484,5117
13201,"Miller County, Georgia",1711,824,0,435,389,887,3934,2810,79,2331,400,1124,5705,3690,79,2822,789,2015
13205,"Mitchell County, Georgia",9613,7534,53,5854,1627,2079,9571,8096,130,6603,1363,1475,20355,16656,233,13097,3326,3699
13207,"Monroe County, Georgia",5737,4582,93,2823,1666,1155,18798,17319,211,15680,1428,1479,25636,22786,318,19354,3114,2850
13209,"Montgomery County, Georgia",1968,1625,10,1288,327,343,5449,4681,21,4217,443,768,8182,6866,31,5982,853,1316
13211,"Morgan County, Georgia",4170,3431,30,2635,766,739,12807,11891,66,10165,1660,916,17843,16082,99,13351,2632,1761
13213,"Murray County, Georgia",306,296,0,219,77,10,32727,28910,332,26002,2576,3817,39231,34750,373,31330,3047,4481
13215,"Muscogee County, Georgia",87221,73975,49,59851,14075,13246,77935,71866,217,65842,5807,6069,190626,169133,266,145991,22876,21493
13217,"Newton County, Georgia",44987,42097,19,38552,3526,2890,50466,47205,186,42693,4326,3261,103683,97109,205,87915,8989,6574
13219,"Oconee County, Georgia",1839,1720,9,1157,554,119,30434,29322,112,27292,1918,1112,35761,34383,121,31201,3061,1378
13221,"Oglethorpe County, Georgia",2579,1412,0,1286,126,1167,11048,8890,53,7675,1162,2158,14523,11050,106,9553,1391,3473
13223,"Paulding County, Georgia",28040,26586,0,23852,2734,1454,110886,105431,317,95212,9902,5455,151740,144534,345,130358,13831,7206
13225,"Peach County, Georgia",10682,8950,0,7535,1415,1732,11899,10805,91,9949,765,1094,24898,21870,91,19466,2313,3028
13227,"Pickens County, Georgia",58,24,0,24,0,34,28222,25900,0,24301,1599,2322,30011,27369,0,25602,1767,2642
13229,"Pierce County, Georgia",1659,1250,0,1091,159,409,15970,13681,53,10582,3046,2289,18963,16101,53,12313,3735,2862
13231,"Pike County, Georgia",1797,1462,0,1369,93,335,15346,14010,92,12415,1503,1336,17671,15974,92,14273,1609,1697
13233,"Polk County, Georgia",5155,4291,0,3450,841,864,29670,26527,244,22702,3581,3143,41178,36746,244,31276,5226,4432
13235,"Pulaski County, Georgia",3086,2043,17,1680,346,1043,6200,5291,56,4267,968,909,9853,7786,73,6358,1355,2067
13237,"Putnam County, Georgia",5490,4982,0,3642,1340,508,13924,12810,8,11421,1381,1114,21239,19549,8,16307,3234,1690
13239,"Quitman County, Georgia",1086,644,8,319,317,442,897,725,24,664,37,172,2140,1526,32,1140,354,614
13241,"Rabun County, Georgia",89,66,0,66,0,23,14103,11507,88,10430,989,2596,15948,12718,107,11376,1235,3230
13243,"Randolph County, Georgia",4218,3249,53,2670,526,969,2538,2131,85,1890,156,407,7028,5652,165,4805,682,1376
13245,"Richmond County, Georgia",109268,93207,221,75366,17620,16061,67222,59723,197,53275,6251,7499,192160,167358,418,141931,25009,24802
13247,"Rockdale County, Georgia",45549,43446,81,35455,7910,2103,30123,27502,138,24448,2916,2621,87647,81526,219,67022,14285,6121
13249,"Schley County, Georgia",1447,1092,0,775,317,355,3474,3175,12,2874,289,299,5166,4457,12,3830,615,709
13251,"Screven County, Georgia",5608,4216,47,3349,820,1392,7506,6554,24,5994,536,952,13629,11217,71,9745,1401,2412
13253,"Seminole County, Georgia",2836,2021,123,1780,118,815,5209,4055,105,3338,612,1154,8448,6354,228,5370,756,2094
13255,"Spalding County, Georgia",20863,16290,79,11607,4604,4573,37481,31916,89,28748,3079,5565,62987,52452,177,43827,8448,10535
13257,"Stephens County, Georgia",2929,2326,0,1596,730,603,20700,18305,252,15990,2063,2395,24917,21919,252,18505,3162,2998
13259,"Stewart County, Georgia",2483,1700,15,1245,440,783,1391,1141,2,931,208,250,3972,2923,17,2222,684,1049
13261,"Sumter County, Georgia",14932,12442,26,9819,2597,2490,11439,10222,129,8928,1165,1217,28618,24557,155,20482,3920,4061
13263,"Talbot County, Georgia",3622,2609,4,1924,681,1013,2578,2133,53,1821,259,445,6405,4940,146,3854,940,1465
13265,"Taliaferro County, Georgia",1134,714,0,423,291,420,620,460,12,261,187,160,1836,1192,12,692,488,644
13267,"Tattnall County, Georgia",3524,2826,0,1772,1054,698,13002,11441,77,9644,1720,1561,19113,16561,77,13450,3034,2552
13269,"Taylor County, Georgia",3242,2253,73,1467,713,989,4641,3683,0,3188,495,958,8053,6091,73,4810,1208,1962
13271,"Telfair County, Georgia",5245,2086,0,1098,988,3159,7594,3532,0,2432,1100,4062,13030,5720,0,3587,2133,7310
13273,"Terrell County, Georgia",5371,3957,15,3441,501,1414,3063,2694,12,2492,190,369,8659,6860,27,6118,715,1799
13275,"Thomas County, Georgia",15676,12377,18,10906,1453,3299,25498,23388,132,21776,1480,2110,44061,38416,150,35100,3166,5645
13277,"Tift County, Georgia",11506,7877,93,6348,1436,3629,21397,17358,295,15243,1820,4039,38607,29834,402,25290,4142,8773
13279,"Toombs County, Georgia",6782,4669,0,4245,424,2113,16166,13545,16,11924,1605,2621,26720,20871,16,18328,2527,5849
13281,"Towns County, Georgia",36,14,0,14,0,22,9975,8218,18,7520,680,1757,10340,8484,18,7786,680,1856
13283,"Treutlen County, Georgia",1794,1348,26,1108,214,446,4351,3633,0,3228,405,718,6288,5033,26,4375,632,1255
13285,"Troup County, Georgia",23589,19447,98,13973,5376,4142,39096,35327,50,31916,3361,3769,67825,59136,181,49816,9139,8689
13287,"Turner County, Georgia",3250,2238,0,1872,366,1012,4246,3750,0,3399,351,496,7650,6141,0,5414,727,1509
13289,"Twiggs County, Georgia",3520,2257,0,2005,252,1263,4524,3099,99,2192,808,1425,8248,5560,99,4263,1198,2688
13291,"Union County, Georgia",31,27,0,27,0,4,20628,18401,83,15319,2999,2227,21747,19427,100,16262,3065,2320
13293,"Upson County, Georgia",7263,5643,94,4953,596,1620,17395,14685,185,12641,1859,2710,25685,21181,279,18412,2490,4504
13295,"Walker County, Georgia",2720,2132,0,1990,142,588,61615,53002,433,47241,5328,8613,67238,57851,433,51607,5811,9387
13297,"Walton County, Georgia",14517,12966,93,9280,3593,1551,66788,62718,296,56258,6164,4070,87914,82054,389,70874,10791,5860
13299,"Ware County, Georgia",9189,7212,30,5798,1384,1977,21859,19234,115,15339,3780,2625,33253,28187,145,22756,5286,5066
13301,"Warren County, Georgia",3241,2322,9,1394,919,919,1965,1522,24,1039,459,443,5326,3917,33,2503,1381,1409
13303,"Washington County, Georgia",9757,7100,64,5493,1543,2657,8351,7609,48,6733,828,742,18732,15086,112,12543,2431,3646
13305,"Wayne County, Georgia",4911,4094,47,3054,993,817,20516,17515,60,14669,2786,3001,27708,23699,107,19480,4112,4009
13307,"Webster County, Georgia",1280,863,153,486,224,417,1269,1105,0,1016,89,164,2622,2041,181,1521,339,581
13309,"Wheeler County, Georgia",2196,778,5,703,70,1418,3887,1333,112,983,238,2554,6121,2138,117,1713,308,3983
13311,"White County, Georgia",475,267,0,222,45,208,26108,21440,204,19048,2188,4668,28103,23223,204,20349,2670,4880
13313,"Whitfield County, Georgia",3890,3269,152,2804,313,621,60900,52728,616,48170,3942,8172,102652,88729,1391,81003,6335,13923
13315,"Wilcox County, Georgia",1632,888,76,620,192,744,4735,3258,3,2754,501,1477,6814,4436,79,3545,812,2378
13317,"Wilkes County, Georgia",4153,1929,2,1474,453,2224,5020,3761,137,2928,696,1259,9806,6000,148,4677,1175,3806
13319,"Wilkinson County, Georgia",3427,2223,13,1594,616,1204,5160,4106,110,3305,691,1054,9041,6769,123,5260,1386,2272
13321,"Worth County, Georgia",5835,4440,7,3602,831,1395,13909,11644,92,10459,1093,2265,20652,16942,99,14902,1941,3710
15001,"Hawaii County, Hawaii",1176,1133,0,1077,56,43,58557,54343,528,49402,4413,4214,192964,172674,2011,150321,20342,20290
15003,"Honolulu County, Hawaii",20328,19922,69,19018,835,406,172921,167382,441,159089,7852,5539,952713,896871,2434,838885,55552,55842
15005,"Kalawao County, Hawaii",0,0,0,0,0,0,13,13,0,11,2,0,74,58,0,49,9,16
15007,"Kauai County, Hawaii",482,370,0,363,7,112,20867,19984,335,18477,1172,883,70316,64690,1771,58214,4705,5626
15009,"Maui County, Hawaii",849,787,0,787,0,62,49336,47045,122,43902,3021,2291,161419,149731,762,138103,10866,11688
16001,"Ada County, Idaho",5424,5249,0,4371,878,175,364847,346960,2008,311302,33650,17887,427127,405493,2476,360935,42082,21634
16003,"Adams County, Idaho",13,13,0,13,0,0,3606,3067,67,2503,497,539,3877,3233,67,2616,550,644
16005,"Bannock County, Idaho",460,429,0,333,96,31,69619,66169,375,60540,5254,3450,81939,77763,425,70717,6621,4176
16007,"Bear Lake County, Idaho",48,32,0,26,6,16,5527,4997,26,4625,346,530,5904,5354,28,4929,397,550
16009,"Benewah County, Idaho",22,22,0,22,0,0,7596,6570,100,5248,1222,1026,8966,7689,118,6152,1419,1277
16011,"Bingham County, Idaho",141,141,0,141,0,0,33386,31653,288,29664,1701,1733,45100,41297,361,38108,2828,3803
16013,"Blaine County, Idaho",33,33,0,0,33,0,16210,15488,43,14378,1067,722,21178,20014,43,18293,1678,1164
16015,"Boise County, Idaho",7,7,0,7,0,0,6345,5846,94,4924,828,499,6897,6324,94,5289,941,573
16017,"Bonner County, Idaho",80,80,0,80,0,0,38778,35045,448,29622,4975,3733,41417,37471,448,31808,5215,3946
16019,"Bonneville County, Idaho",523,440,0,432,8,83,91233,87099,416,81041,5642,4134,108844,103498,494,95891,7113,5346
16021,"Boundary County, Idaho",25,17,0,17,0,8,10203,9080,230,7744,1106,1123,11215,10064,230,8561,1273,1151
16023,"Butte County, Idaho",64,64,0,64,0,0,2429,2168,50,1915,203,261,2567,2301,50,2030,221,266
16025,"Camas County, Idaho",0,0,0,0,0,0,801,689,0,601,88,112,886,774,0,637,137,112
16027,"Canyon County, Idaho",884,865,0,809,56,19,144277,135689,1448,119796,14445,8588,203769,189991,1969,163390,24632,13778
16029,"Caribou County, Idaho",0,0,0,0,0,0,6336,5952,10,5593,349,384,6771,6364,10,5985,369,407
16031,"Cassia County, Idaho",8,8,0,8,0,0,16248,15334,11,14079,1244,914,23069,21473,39,19680,1754,1596
16033,"Clark County, Idaho",0,0,0,0,0,0,533,463,30,362,71,70,1035,802,30,526,246,233
16035,"Clearwater County, Idaho",7,3,0,3,0,4,6981,5887,148,5147,592,1094,7498,6372,157,5558,657,1126
16037,"Custer County, Idaho",0,0,0,0,0,0,3717,3335,81,2978,276,382,4026,3639,81,3222,336,387
16039,"Elmore County, Idaho",698,620,0,620,0,78,18791,17583,141,16192,1250,1208,25556,23404,156,21372,1876,2152
16041,"Franklin County, Idaho",33,33,0,33,0,0,11937,11168,333,9944,891,769,13067,12027,333,10736,958,1040
16043,"Fremont County, Idaho",24,21,0,21,0,3,10592,9719,170,8908,641,873,12328,11158,264,10157,737,1170
16045,"Gem County, Idaho",0,0,0,0,0,0,14732,13320,194,11769,1357,1412,16709,15176,534,13093,1549,1533
16047,"Gooding County, Idaho",15,11,0,11,0,4,10254,8916,60,7824,1032,1338,15016,13062,94,11238,1730,1954
16049,"Idaho County, Idaho",11,11,0,11,0,0,14290,12167,205,10204,1758,2123,15540,13226,205,11018,2003,2314
16051,"Jefferson County, Idaho",19,19,0,19,0,0,23841,22705,264,20401,2040,1136,27381,25796,375,22991,2430,1585
16053,"Jerome County, Idaho",21,21,0,18,3,0,14402,13144,152,11842,1150,1258,22873,19749,176,16883,2690,3124
16055,"Kootenai County, Idaho",632,603,0,564,39,29,135046,126615,484,115513,10618,8431,148340,139298,531,127181,11586,9042
16057,"Latah County, Idaho",232,232,0,171,61,0,32041,30654,271,27490,2893,1387,35444,34027,292,30463,3272,1417
16059,"Lemhi County, Idaho",13,13,0,0,13,0,7087,6292,154,5512,626,795,7550,6755,154,5937,664,795
16061,"Lewis County, Idaho",4,4,0,4,0,0,3238,2737,39,2365,333,501,3774,3208,46,2721,441,566
16063,"Lincoln County, Idaho",0,0,0,0,0,0,3533,3136,31,2656,449,397,5248,4386,31,3622,733,862
16065,"Madison County, Idaho",221,209,0,173,36,12,33581,33005,190,28145,4670,576,37667,36736,190,30938,5608,931
16067,"Minidoka County, Idaho",49,38,0,38,0,11,12838,11793,109,11028,656,1045,20369,18677,155,16561,1961,1692
16069,"Nez Perce County, Idaho",146,146,0,146,0,0,34052,31364,331,27770,3263,2688,38973,35776,342,31677,3757,3197
16071,"Oneida County, Idaho",3,3,0,3,0,0,3986,3766,81,3417,268,220,4253,4022,81,3645,296,231
16073,"Owyhee County, Idaho",0,0,0,0,0,0,7654,6607,255,5547,805,1047,11242,8988,285,7027,1676,2254
16075,"Payette County, Idaho",90,90,0,90,0,0,17895,16443,314,14413,1716,1452,22694,20506,325,17448,2733,2188
16077,"Power County, Idaho",20,20,0,20,0,0,4742,4371,3,4132,236,371,7597,6990,3,6078,909,607
16079,"Shoshone County, Idaho",6,6,0,0,6,0,11241,10026,74,8338,1614,1215,12202,10913,114,9013,1786,1289
16081,"Teton County, Idaho",20,20,0,14,6,0,8741,8163,0,7551,612,578,10776,9796,0,8991,805,980
16083,"Twin Falls County, Idaho",513,466,0,291,175,47,64991,60586,763,54575,5248,4405,81029,75089,803,67057,7229,5940
16085,"Valley County, Idaho",0,0,0,0,0,0,9418,9083,101,7270,1712,335,9925,9545,101,7732,1712,380
16087,"Washington County, Idaho",0,0,0,0,0,0,7776,6783,114,5702,967,993,9857,8570,114,7043,1413,1287
17001,"Adams County, Illinois",2451,2047,30,1435,582,404,60327,53033,580,48121,4332,7294,65312,57409,700,51662,5047,7903
17003,"Alexander County, Illinois",2234,1367,0,1162,205,867,4079,2481,31,1919,531,1598,6556,3993,31,3142,820,2563
17005,"Bond County, Illinois",353,340,0,319,21,13,14143,12356,46,11225,1085,1787,15279,13417,95,12186,1136,1862
17007,"Boone County, Illinois",1167,1078,56,988,34,89,39447,36768,169,34702,1897,2679,53297,49346,399,46290,2657,3951
17009,"Brown County, Illinois",20,13,0,13,0,7,4668,4024,40,3674,310,644,4809,4153,40,3771,342,656
17011,"Bureau County, Illinois",249,229,0,223,6,20,29310,26258,159,23760,2339,3052,33181,29632,159,26623,2850,3549
17013,"Calhoun County, Illinois",0,0,0,0,0,0,4632,3858,24,3311,523,774,4775,3976,30,3410,536,799
17015,"Carroll County, Illinois",190,159,0,78,81,31,13519,12029,65,10985,979,1490,14465,12901,65,11682,1154,1564
17017,"Cass County, Illinois",575,416,0,238,178,159,9664,8379,58,7351,970,1285,12694,11105,99,9453,1553,1589
17019,"Champaign County, Illinois",25495,22125,76,18303,3746,3370,132498,125454,288,115153,10013,7044,192192,180511,441,162249,17821,11681
17021,"Christian County, Illinois",142,129,0,124,5,13,30577,27293,315,23936,3042,3284,31595,28199,315,24699,3185,3396
17023,"Clark County, Illinois",40,22,0,10,12,18,15192,13485,48,11235,2202,1707,15699,13950,48,11665,2237,1749
17025,"Clay County, Illinois",12,12,0,12,0,0,12652,11248,46,9779,1423,1404,13050,11577,46,10047,1484,1473
17027,"Clinton County, Illinois",333,333,4,235,94,0,33522,29563,269,27522,1772,3959,35346,31157,273,28918,1966,4189
17029,"Coles County, Illinois",1389,1286,0,1093,193,103,44796,40243,74,36480,3689,4553,48469,43557,74,39139,4344,4912
17031,"Cook County, Illinois",1213176,1018391,4273,843195,170923,194785,2190851,2037918,11461,1913363,113094,152933,5146835,4640530,23638,4142914,473978,506305
17033,"Crawford County, Illinois",36,36,0,36,0,0,16731,14709,217,13065,1427,2022,17253,15177,220,13496,1461,2076
17035,"Cumberland County, Illinois",0,0,0,0,0,0,10428,8937,87,7825,1025,1491,10773,9231,87,8048,1096,1542
17037,"DeKalb County, Illinois",6446,6250,0,5872,378,196,78607,74298,213,69739,4346,4309,99467,94526,232,88336,5958,4941
17039,"De Witt County, Illinois",23,23,0,23,0,0,14215,12686,63,11297,1326,1529,15909,14050,63,12387,1600,1859
17041,"Douglas County, Illinois",50,30,0,30,0,20,17788,14339,69,13159,1111,3449,19637,16091,72,14767,1252,3546
17043,"DuPage County, Illinois",42628,39613,127,35957,3529,3015,622869,594182,2384,567036,24762,28687,919084,877843,3277,831428,43138,41241
17045,"Edgar County, Illinois",64,64,0,64,0,0,16813,14349,77,13041,1231,2464,17268,14757,77,13406,1274,2511
17047,"Edwards County, Illinois",23,23,0,23,0,0,6311,5584,53,4995,536,727,6514,5782,53,5180,549,732
17049,"Effingham County, Illinois",159,139,0,136,3,20,32377,29144,273,26729,2142,3233,33691,30399,279,27924,2196,3292
17051,"Fayette County, Illinois",118,107,0,107,0,11,19589,15312,85,13829,1398,4277,20111,15794,85,14254,1455,4317
17053,"Ford County, Illinois",93,70,0,70,0,23,12348,10961,57,10237,667,1387,13063,11593,57,10755,781,1470
17055,"Franklin County, Illinois",233,217,30,151,36,16,37333,31820,280,27758,3782,5513,38833,33158,377,28692,4089,5675
17057,"Fulton County, Illinois",240,240,0,223,17,0,31838,27678,259,24804,2615,4160,33122,28887,259,25891,2737,4235
17059,"Gallatin County, Illinois",12,8,0,8,0,4,5004,4257,24,3782,451,747,5218,4455,24,3964,467,763
17061,"Greene County, Illinois",7,7,0,7,0,0,12748,10653,90,9287,1276,2095,13022,10907,94,9537,1276,2115
17063,"Grundy County, Illinois",714,667,0,521,146,47,43607,41197,303,38005,2889,2410,50025,47438,303,43898,3237,2587
17065,"Hamilton County, Illinois",31,31,0,31,0,0,8076,6894,149,5902,843,1182,8145,6963,149,5964,850,1182
17067,"Hancock County, Illinois",85,38,0,38,0,47,17392,14736,143,12899,1694,2656,17987,15232,144,13351,1737,2755
17069,"Hardin County, Illinois",101,101,0,101,0,0,3839,3142,15,2761,366,697,4060,3359,15,2976,368,701
17071,"Henderson County, Illinois",3,3,0,3,0,0,6630,5760,20,5048,692,870,6872,5950,20,5233,697,922
17073,"Henry County, Illinois",702,498,0,409,89,204,44610,39791,424,36034,3333,4819,48896,43511,455,39163,3893,5385
17075,"Iroquois County, Illinois",288,283,0,155,128,5,25314,22464,209,20406,1849,2850,28000,24906,209,22524,2173,3094
17077,"Jackson County, Illinois",7542,6838,64,5226,1548,704,41261,36604,204,31648,4752,4657,54681,49098,274,42144,6680,5583
17079,"Jasper County, Illinois",20,20,0,20,0,0,9290,7926,140,7124,662,1364,9536,8156,140,7322,694,1380
17081,"Jefferson County, Illinois",2286,2005,0,1683,322,281,31611,27800,138,24889,2773,3811,35756,31445,138,28112,3195,4311
17083,"Jersey County, Illinois",33,33,0,33,0,0,20488,18196,371,15956,1869,2292,21227,18928,371,16629,1928,2299
17085,"Jo Daviess County, Illinois",64,56,0,52,4,8,20761,18851,149,17042,1660,1910,21842,19845,149,18001,1695,1997
17087,"Johnson County, Illinois",16,6,0,6,0,10,10362,8033,100,7016,917,2329,10619,8233,100,7206,927,2386
17089,"Kane County, Illinois",28844,25151,12,22471,2668,3693,301094,287632,1376,275764,10492,13462,523816,496216,1883,464998,29335,27600
17091,"Kankakee County, Illinois",15716,13139,46,9836,3257,2577,76122,69847,469,64099,5279,6275,105237,95078,682,83808,10588,10159
17093,"Kendall County, Illinois",8173,8169,0,8012,157,4,87311,85056,117,83130,1809,2255,122578,119482,117,116950,2415,3096
17095,"Knox County, Illinois",3041,2347,0,1895,452,694,40836,35038,371,31158,3509,5798,47130,40387,382,35758,4247,6743
17097,"Lake County, Illinois",45030,40210,67,36130,4013,4820,431068,413893,1475,397660,14758,17175,686556,654028,1989,619197,32842,32528
17099,"LaSalle County, Illinois",1562,1229,26,1173,30,333,93923,84222,529,78836,4857,9701,107819,96605,661,90336,5608,11214
17101,"Lawrence County, Illinois",56,56,0,52,4,0,13192,11341,85,9974,1282,1851,13983,12089,85,10576,1428,1894
17103,"Lee County, Illinois",409,305,0,298,7,104,28862,26164,70,23817,2277,2698,31355,28453,73,25968,2412,2902
17105,"Livingston County, Illinois",382,361,0,330,31,21,31750,28838,347,25655,2836,2912,34187,31130,354,27652,3124,3057
17107,"Logan County, Illinois",114,102,0,80,22,12,23618,21285,152,19545,1588,2333,25148,22671,152,20754,1765,2477
17109,"McDonough County, Illinois",615,569,0,311,258,46,25570,22947,157,20539,2251,2623,27886,25140,168,22339,2633,2746
17111,"McHenry County, Illinois",3828,3494,0,3361,133,334,251176,241104,1044,233030,7030,10072,306395,294244,1285,283781,9178,12151
17113,"McLean County, Illinois",13149,12159,171,9487,2501,990,133093,126381,975,113780,11626,6712,165907,157397,1232,139915,16250,8510
17115,"Macon County, Illinois",13891,11248,3,9859,1386,2643,80145,72168,686,65742,5740,7977,103839,91963,689,83226,8048,11876
17117,"Macoupin County, Illinois",289,267,0,248,19,22,43438,39042,431,35884,2727,4396,45026,40563,433,37309,2821,4463
17119,"Madison County, Illinois",21634,18517,15,15818,2684,3117,223650,205494,1015,193051,11428,18156,260673,238331,1063,221927,15341,22342
17121,"Marion County, Illinois",1256,1042,29,905,108,214,34346,30562,209,27359,2994,3784,37539,33242,238,29668,3336,4297
17123,"Marshall County, Illinois",24,24,0,24,0,0,11077,9842,111,8991,740,1235,11645,10383,111,9449,823,1262
17125,"Mason County, Illinois",56,56,0,42,14,0,13255,11672,109,10352,1211,1583,13674,12020,109,10664,1247,1654
17127,"Massac County, Illinois",875,380,48,301,31,495,12633,9516,133,8792,591,3117,14263,10498,181,9551,766,3765
17129,"Menard County, Illinois",49,43,0,38,5,6,11785,10717,99,9890,728,1068,12272,11174,99,10311,764,1098
17131,"Mercer County, Illinois",49,49,0,49,0,0,14930,13529,132,12382,1015,1401,15545,14125,173,12809,1143,1420
17133,"Monroe County, Illinois",120,22,0,22,0,98,32324,30116,178,28082,1856,2208,33467,31132,178,29052,1902,2335
17135,"Montgomery County, Illinois",208,189,0,147,42,19,24317,21453,207,18583,2663,2864,25177,22228,207,19168,2853,2949
17137,"Morgan County, Illinois",1233,1054,0,986,68,179,28401,25488,197,22608,2683,2913,30751,27337,197,24348,2792,3414
17139,"Moultrie County, Illinois",14,14,0,14,0,0,14067,11450,69,10175,1206,2617,14355,11736,69,10409,1258,2619
17141,"Ogle County, Illinois",499,425,0,380,45,74,44590,40893,296,37341,3256,3697,51058,46933,321,42371,4241,4125
17143,"Peoria County, Illinois",31867,25204,14,19057,6133,6663,127131,115372,856,104602,9914,11759,180920,160449,953,140787,18709,20471
17145,"Perry County, Illinois",173,154,0,137,17,19,17870,15245,129,13788,1328,2625,18832,16143,129,14578,1436,2689
17147,"Piatt County, Illinois",139,131,0,121,10,8,15193,14186,64,13234,888,1007,16355,15266,73,14223,970,1089
17149,"Pike County, Illinois",62,62,0,40,22,0,14921,12548,152,10499,1897,2373,15392,13000,156,10895,1949,2392
17151,"Pope County, Illinois",120,68,0,0,68,52,3798,2886,50,2598,238,912,4100,3136,50,2769,317,964
17153,"Pulaski County, Illinois",1721,1044,0,928,116,677,3614,2756,19,2360,377,858,5665,4044,25,3493,526,1621
17155,"Putnam County, Illinois",23,23,0,23,0,0,5331,4844,15,4259,570,487,5765,5273,15,4543,715,492
17157,"Randolph County, Illinois",1089,858,0,770,88,231,26543,22701,380,19953,2368,3842,28660,24522,531,21393,2598,4138
17159,"Richland County, Illinois",20,20,0,20,0,0,15010,13129,294,11814,1021,1881,15638,13726,294,12408,1024,1912
17161,"Rock Island County, Illinois",13526,11783,19,10429,1335,1743,103096,92937,655,85655,6627,10159,141414,127068,766,115579,10723,14346
17163,"St. Clair County, Illinois",77676,57174,446,45221,11507,20502,161949,147063,1057,134765,11241,14886,260609,223144,1583,196441,25120,37465
17165,"Saline County, Illinois",744,605,45,489,71,139,21988,18392,353,15579,2460,3596,23917,20046,398,16987,2661,3871
17167,"Sangamon County, Illinois",24363,20698,156,16881,3661,3665,157221,145572,654,133531,11387,11649,193997,178086,810,160650,16626,15911
17169,"Schuyler County, Illinois",41,41,0,41,0,0,6267,5561,28,5161,372,706,6327,5616,28,5212,376,711
17171,"Scott County, Illinois",6,6,0,6,0,0,4922,4433,72,3975,386,489,5059,4544,72,4082,390,515
17173,"Shelby County, Illinois",123,123,0,117,6,0,21163,18511,493,15071,2947,2652,21692,19007,493,15523,2991,2685
17175,"Stark County, Illinois",23,23,0,19,4,0,5258,4396,19,3982,395,862,5451,4557,19,4129,409,894
17177,"Stephenson County, Illinois",4250,3669,0,3186,483,581,37526,33663,177,30988,2498,3863,45009,40374,178,37123,3073,4635
17179,"Tazewell County, Illinois",892,837,0,663,174,55,125203,114242,521,105558,8163,10961,131990,120671,591,111454,8626,11319
17181,"Union County, Illinois",140,126,0,86,40,14,15308,12399,307,10599,1493,2909,16759,13279,379,11255,1645,3480
17183,"Vermilion County, Illinois",9774,6641,17,5452,1172,3133,61413,52290,429,46953,4908,9123,76422,63158,458,56127,6573,13264
17185,"Wabash County, Illinois",80,80,0,80,0,0,10914,9898,192,8731,975,1016,11480,10458,214,9108,1136,1022
17187,"Warren County, Illinois",313,190,15,175,0,123,13807,12358,210,10610,1538,1449,16218,14539,347,12592,1600,1679
17189,"Washington County, Illinois",45,45,0,45,0,0,13528,11631,100,10550,981,1897,14000,12085,100,10947,1038,1915
17191,"Wayne County, Illinois",96,89,0,14,75,7,15905,12999,148,11389,1462,2906,16494,13448,148,11729,1571,3046
17193,"White County, Illinois",12,11,0,10,1,1,13405,11884,220,10523,1141,1521,13798,12210,220,10840,1150,1588
17195,"Whiteside County, Illinois",848,801,0,637,164,47,47365,42040,216,38541,3283,5325,55754,49577,222,45292,4063,6177
17197,"Will County, Illinois",73243,68272,324,62230,5718,4971,441193,422267,2082,403838,16347,18926,678359,647301,2872,610312,34117,31058
17199,"Williamson County, Illinois",2236,2004,0,1731,273,232,59518,50466,529,46489,3448,9052,65374,55809,537,51053,4219,9565
17201,"Winnebago County, Illinois",35355,29073,71,24135,4867,6282,199013,183022,1364,169056,12602,15991,283205,257703,1657,233431,22615,25502
17203,"Woodford County, Illinois",119,119,0,67,52,0,36356,33603,295,31158,2150,2753,37860,35019,298,32392,2329,2841
18001,"Adams County, Indiana",311,117,0,117,0,194,32300,23012,656,19819,2537,9288,34453,24764,687,21363,2714,9689
18003,"Allen County, Indiana",41103,35589,224,28123,7242,5514,270207,250434,1106,230084,19244,19773,362084,333195,1589,297895,33711,28889
18005,"Bartholomew County, Indiana",1415,1294,19,1084,191,121,66657,59515,550,53171,5794,7142,80021,71334,586,63508,7240,8687
18007,"Benton County, Indiana",66,66,0,66,0,0,7966,7232,98,5948,1186,734,8560,7787,98,6411,1278,773
18009,"Blackford County, Indiana",0,0,0,0,0,0,11595,9989,86,8439,1464,1606,12054,10432,86,8643,1703,1622
18011,"Boone County, Indiana",991,965,0,877,88,26,57165,54010,342,49760,3908,3155,62376,59022,358,54547,4117,3354
18013,"Brown County, Indiana",77,77,0,77,0,0,14254,13045,147,10107,2791,1209,14866,13520,159,10520,2841,1346
18015,"Carroll County, Indiana",90,89,0,82,7,1,18748,16823,171,14433,2219,1925,19876,17906,182,15186,2538,1970
18017,"Cass County, Indiana",282,247,0,243,4,35,30149,26818,170,22847,3801,3331,37136,33147,219,27782,5146,3989
18019,"Clark County, Indiana",7497,6804,123,5332,1349,693,94789,86179,419,76874,8886,8610,113043,102994,542,90723,11729,10049
18021,"Clay County, Indiana",56,56,0,56,0,0,25051,21623,356,18835,2432,3428,25922,22419,356,19555,2508,3503
18023,"Clinton County, Indiana",266,266,0,206,60,0,26383,24087,169,21064,2854,2296,31829,29001,319,24795,3887,2828
18025,"Crawford County, Indiana",8,8,0,8,0,0,10125,8604,188,6381,2035,1521,10496,8833,188,6586,2059,1663
18027,"Daviess County, Indiana",548,534,0,256,278,14,29744,22004,386,18747,2871,7740,32203,24147,402,19683,4062,8056
18029,"Dearborn County, Indiana",339,287,0,287,0,52,47260,43812,650,39438,3724,3448,48978,45427,652,40952,3823,3551
18031,"Decatur County, Indiana",124,124,0,100,24,0,24814,21977,237,17620,4120,2837,26105,23226,237,18710,4279,2879
18033,"DeKalb County, Indiana",106,106,0,89,17,0,40022,36557,368,32592,3597,3465,42042,38431,372,34202,3857,3611
18035,"Delaware County, Indiana",7870,7138,9,5417,1712,732,94905,86513,548,76476,9489,8392,108656,98972,557,86597,11818,9684
18037,"Dubois County, Indiana",212,212,0,99,113,0,37735,34108,368,31378,2362,3627,41401,37315,368,34161,2786,4086
18039,"Elkhart County, Indiana",10630,8562,27,6880,1655,2068,150265,128579,1891,117597,9091,21686,199392,171649,2149,153729,15771,27743
18041,"Fayette County, Indiana",568,444,0,435,9,124,22056,19018,104,14512,4402,3038,23000,19791,114,15188,4489,3209
18043,"Floyd County, Indiana",3870,2983,0,2215,768,887,66437,60271,461,54224,5586,6166,75173,67608,490,60269,6849,7565
18045,"Fountain County, Indiana",32,27,0,27,0,5,15717,13935,94,12202,1639,1782,16427,14591,94,12809,1688,1836
18047,"Franklin County, Indiana",25,25,0,25,0,0,22289,19462,289,16153,3020,2827,22639,19812,295,16474,3043,2827
18049,"Fulton County, Indiana",182,159,0,138,21,23,18526,15927,134,13136,2657,2599,20064,17269,142,14240,2887,2795
18051,"Gibson County, Indiana",599,512,0,470,42,87,30997,28314,166,25170,2978,2683,32771,29756,166,26492,3098,3015
18053,"Grant County, Indiana",4772,4134,0,3012,1122,638,53079,46825,602,38380,7843,6254,62395,55112,613,44662,9837,7283
18055,"Greene County, Indiana",75,73,0,65,8,2,31151,25954,294,22221,3439,5197,32132,26891,294,23069,3528,5241
18057,"Hamilton County, Indiana",11036,10844,0,10267,577,192,260375,254590,922,246014,7654,5785,308159,301498,1256,291105,9137,6661
18059,"Hancock County, Indiana",1298,1298,0,1298,0,0,67131,63485,252,58117,5116,3646,72115,68439,252,62659,5528,3676
18061,"Harrison County, Indiana",72,72,0,52,20,0,37437,33957,928,27762,5267,3480,39120,35532,968,29096,5468,3588
18063,"Hendricks County, Indiana",9290,9150,71,8038,1041,140,133620,128517,1007,120440,7070,5103,155459,149900,1148,140172,8580,5559
18065,"Henry County, Indiana",560,520,0,475,45,40,43230,38088,508,31565,6015,5142,45286,39862,508,33076,6278,5424
18067,"Howard County, Indiana",5884,4774,21,3986,767,1110,69823,62812,560,56263,5989,7011,81360,72791,581,64882,7328,8569
18069,"Huntington County, Indiana",216,216,0,191,25,0,33534,30387,380,26445,3562,3147,35116,31892,403,27699,3790,3224
18071,"Jackson County, Indiana",438,438,0,438,0,0,38446,33313,458,29661,3194,5133,43061,37246,468,33205,3573,5815
18073,"Jasper County, Indiana",163,137,0,132,5,26,29890,27501,272,24789,2440,2389,32519,29859,344,26899,2616,2660
18075,"Jay County, Indiana",24,19,0,5,14,5,19869,16057,375,12919,2763,3812,20832,16660,378,13297,2985,4172
18077,"Jefferson County, Indiana",430,398,8,385,5,32,27780,24553,172,21238,3143,3227,29687,26361,180,23012,3169,3326
18079,"Jennings County, Indiana",353,308,0,181,127,45,26232,22672,278,18879,3515,3560,27483,23775,278,19842,3655,3708
18081,"Johnson County, Indiana",3236,2944,0,2708,236,292,132947,125179,972,113442,10765,7768,147008,138653,972,125522,12159,8355
18083,"Knox County, Indiana",737,698,0,503,195,39,33285,30209,169,26655,3385,3076,35386,32101,172,28172,3757,3285
18085,"Kosciusko County, Indiana",502,394,0,394,0,108,68384,60806,744,53144,6918,7578,77133,68633,982,59730,7921,8500
18087,"LaGrange County, Indiana",22,22,0,22,0,0,36246,19749,200,16600,2949,16497,38389,21698,205,18265,3228,16691
18089,"Lake County, Indiana",117193,98095,297,78504,19294,19098,262865,240718,1876,224941,13901,22147,482929,431905,2419,384416,45070,51024
18091,"LaPorte County, Indiana",9103,7967,19,5721,2227,1136,84005,76717,624,68245,7848,7288,102337,93171,650,80741,11780,9166
18093,"Lawrence County, Indiana",106,106,0,106,0,0,43174,37665,385,32564,4716,5509,44979,39227,385,34070,4772,5752
18095,"Madison County, Indiana",8292,6934,32,6377,525,1358,106512,94919,394,85090,9435,11593,123320,109518,429,98286,10803,13802
18097,"Marion County, Indiana",252618,210583,574,173906,36103,42035,522463,475592,1875,437020,36697,46871,922947,815037,2946,723350,88741,107910
18099,"Marshall County, Indiana",255,255,0,227,28,0,40462,34819,361,29402,5056,5643,45975,39266,488,32758,6020,6709
18101,"Martin County, Indiana",7,7,0,7,0,0,9845,8244,119,7183,942,1601,10009,8392,119,7308,965,1617
18103,"Miami County, Indiana",1091,960,0,789,171,131,30859,27641,236,23797,3608,3218,33843,30379,272,25743,4364,3464
18105,"Monroe County, Indiana",3937,3619,0,2673,946,318,110192,103940,436,93008,10496,6252,129513,122466,467,108739,13260,7047
18107,"Montgomery County, Indiana",250,204,0,192,12,46,34241,31283,192,27527,3564,2958,37010,33939,192,30020,3727,3071
18109,"Morgan County, Indiana",209,207,0,184,23,2,66185,60645,714,53030,6901,5540,68635,62910,714,54989,7207,5725
18111,"Newton County, Indiana",5,5,0,5,0,0,12667,11557,113,10191,1253,1110,13837,12633,113,10973,1547,1204
18113,"Noble County, Indiana",116,116,0,113,3,0,40895,36791,526,33029,3236,4104,46632,42160,535,38094,3531,4472
18115,"Ohio County, Indiana",77,59,0,59,0,18,5667,4830,38,4428,364,837,5860,4996,38,4594,364,864
18117,"Orange County, Indiana",229,221,0,221,0,8,18496,15308,199,12428,2681,3188,19339,15937,199,12884,2854,3402
18119,"Owen County, Indiana",149,84,0,84,0,65,20050,16976,138,13789,3049,3074,20779,17539,158,14301,3080,3240
18121,"Parke County, Indiana",0,0,0,0,0,0,14974,11772,304,10010,1458,3202,15566,12236,305,10452,1479,3330
18123,"Perry County, Indiana",158,158,0,122,36,0,16864,14229,234,12472,1523,2635,17543,14833,234,12999,1600,2710
18125,"Pike County, Indiana",54,54,0,54,0,0,11912,10270,218,8588,1464,1642,12230,10556,218,8874,1464,1674
18127,"Porter County, Indiana",5745,5463,29,4428,1006,282,137521,128804,1399,118794,8611,8717,163494,153178,1485,140185,11508,10316
18129,"Posey County, Indiana",338,338,0,312,26,0,24403,22369,250,19273,2846,2034,25322,23246,250,20064,2932,2076
18131,"Pulaski County, Indiana",55,41,0,7,34,14,11935,10394,193,8670,1531,1541,12600,11005,204,9148,1653,1595
18133,"Putnam County, Indiana",33,33,0,27,6,0,30955,28565,332,24466,3767,2390,32113,29678,366,25412,3900,2435
18135,"Randolph County, Indiana",152,131,0,131,0,21,23322,20608,335,17515,2758,2714,24814,22050,335,18668,3047,2764
18137,"Ripley County, Indiana",73,73,0,47,26,0,26715,24111,240,21272,2599,2604,27877,25185,240,22141,2804,2692
18139,"Rush County, Indiana",238,205,0,39,166,33,15913,13360,92,9930,3338,2553,16556,13925,92,10250,3583,2631
18141,"St. Joseph County, Indiana",33940,26500,73,20280,6147,7440,188181,169159,1294,155294,12571,19022,256486,226627,1434,201722,23471,29859
18143,"Scott County, Indiana",54,54,0,18,36,0,22398,19306,206,16137,2963,3092,23353,19990,206,16704,3080,3363
18145,"Shelby County, Indiana",348,299,0,283,16,49,40451,36227,256,30750,5221,4224,43619,39208,256,33248,5704,4411
18147,"Spencer County, Indiana",107,35,0,30,5,72,19340,16683,148,14729,1806,2657,20320,17486,157,15412,1917,2834
18149,"Starke County, Indiana",56,56,0,56,0,0,21662,18862,443,15459,2960,2800,22906,19923,467,16314,3142,2983
18151,"Steuben County, Indiana",23,22,0,22,0,1,31241,28673,393,25677,2603,2568,33093,30453,393,27319,2741,2640
18153,"Sullivan County, Indiana",112,112,0,112,0,0,17993,14852,85,12642,2125,3141,18792,15627,85,13365,2177,3165
18155,"Switzerland County, Indiana",82,58,0,58,0,24,10054,8361,244,6936,1181,1693,10509,8682,244,7222,1216,1827
18157,"Tippecanoe County, Indiana",8222,7679,12,6148,1519,543,132467,125654,665,113445,11544,6813,170097,162100,920,142505,18675,7997
18159,"Tipton County, Indiana",0,0,0,0,0,0,14380,12975,76,11394,1505,1405,15062,13657,215,11885,1557,1405
18161,"Union County, Indiana",0,0,0,0,0,0,6874,6062,142,4656,1264,812,7161,6340,142,4934,1264,821
18163,"Vanderburgh County, Indiana",15963,13008,9,9949,3050,2955,147181,133056,662,120649,11745,14125,175089,157067,686,140509,15872,18022
18165,"Vermillion County, Indiana",53,53,0,53,0,0,14933,13126,64,11715,1347,1807,15417,13585,64,12164,1357,1832
18167,"Vigo County, Indiana",4562,3723,31,3421,271,839,86698,77868,698,67907,9263,8830,98595,88328,729,76927,10672,10267
18169,"Wabash County, Indiana",122,122,0,118,4,0,28457,25794,370,21466,3958,2663,29917,27151,377,22648,4126,2766
18171,"Warren County, Indiana",38,38,0,15,23,0,7894,7129,152,6009,968,765,8182,7405,152,6224,1029,777
18173,"Warrick County, Indiana",909,743,0,743,0,166,56434,53184,357,48650,4177,3250,60788,57174,357,52499,4318,3614
18175,"Washington County, Indiana",0,0,0,0,0,0,26689,21590,513,17806,3271,5099,27523,22376,513,18564,3299,5147
18177,"Wayne County, Indiana",3050,2544,14,1842,688,506,57482,49807,490,40282,9035,7675,64303,55736,595,44872,10269,8567
18179,"Wells County, Indiana",206,137,0,137,0,69,25914,23712,208,20718,2786,2202,27279,24821,215,21776,2830,2458
18181,"White County, Indiana",75,75,0,62,13,0,21553,19484,141,17212,2131,2069,23976,21692,150,19072,2470,2284
18183,"Whitley County, Indiana",67,67,0,65,2,0,31731,29236,438,25614,3184,2495,33037,30510,478,26696,3336,2527
19001,"Adair County, Iowa",15,15,0,15,0,0,6804,6107,80,5203,824,697,7032,6327,80,5420,827,705
19003,"Adams County, Iowa",2,2,0,2,0,0,3539,3076,52,2667,357,463,3641,3170,52,2742,376,471
19005,"Allamakee County, Iowa",108,74,0,74,0,34,12395,10295,133,9190,972,2100,13582,11052,133,9840,1079,2530
19007,"Appanoose County, Iowa",67,43,0,43,0,24,11871,10166,141,8603,1422,1705,12392,10646,148,8993,1505,1746
19009,"Audubon County, Iowa",32,20,0,20,0,12,5415,4749,52,4185,512,666,5576,4897,52,4291,554,679
19011,"Benton County, Iowa",161,147,0,147,0,14,24495,22495,310,19302,2883,2000,25303,23207,314,19949,2944,2096
19013,"Black Hawk County, Iowa",11477,8872,42,7904,926,2605,104472,96313,602,88833,6878,8159,127478,115941,675,106095,9171,11537
19015,"Boone County, Iowa",80,52,0,52,0,28,24212,22487,214,19967,2306,1725,25561,23805,214,20998,2593,1756
19017,"Bremer County, Iowa",99,99,0,76,23,0,22263,20269,173,18588,1508,1994,23183,21172,173,19433,1566,2011
19019,"Buchanan County, Iowa",36,36,0,36,0,0,20071,17542,153,15831,1558,2529,20774,18072,153,16269,1650,2702
19021,"Buena Vista County, Iowa",493,468,0,410,58,25,11628,10464,152,9849,463,1164,19331,17852,152,16245,1455,1479
19023,"Butler County, Iowa",27,27,0,27,0,0,14105,12190,234,10817,1139,1915,14569,12602,234,11219,1149,1967
19025,"Calhoun County, Iowa",65,65,0,65,0,0,8680,7685,83,6891,711,995,8988,7971,83,7153,735,1017
19027,"Carroll County, Iowa",295,286,0,286,0,9,19057,16846,161,15571,1114,2211,20012,17757,161,16433,1163,2255
19029,"Cass County, Iowa",18,18,0,18,0,0,12487,11095,54,9364,1677,1392,13021,11607,54,9781,1772,1414
19031,"Cedar County, Iowa",129,129,0,129,0,0,17293,15760,332,14526,902,1533,18053,16512,444,15131,937,1541
19033,"Cerro Gordo County, Iowa",676,656,0,612,44,20,38239,34110,172,31074,2864,4129,41893,37367,172,33626,3569,4526
19035,"Cherokee County, Iowa",74,65,0,65,0,9,10491,9479,63,8919,497,1012,11117,9853,63,9261,529,1264
19037,"Chickasaw County, Iowa",51,44,0,27,17,7,11520,9930,201,8944,785,1590,11944,10293,201,9235,857,1651
19039,"Clarke County, Iowa",6,6,0,0,6,0,7660,6859,35,5995,829,801,9077,8276,35,7214,1027,801
19041,"Clay County, Iowa",60,60,0,2,58,0,15123,13930,55,12613,1262,1193,16065,14765,55,13248,1462,1300
19043,"Clayton County, Iowa",167,123,0,109,14,44,16714,13958,123,12586,1249,2756,17375,14534,130,13068,1336,2841
19045,"Clinton County, Iowa",1174,913,33,704,176,261,42722,37827,492,34535,2800,4895,46696,41366,525,37558,3283,5330
19047,"Crawford County, Iowa",198,198,0,90,108,0,11167,9457,144,8376,937,1710,16582,13926,191,11722,2013,2656
19049,"Dallas County, Iowa",1042,1025,0,887,138,17,69157,66777,381,63279,3117,2380,80266,77607,385,73219,4003,2659
19051,"Davis County, Iowa",8,8,0,8,0,0,8467,5793,39,4982,772,2674,8723,6039,39,5225,775,2684
19053,"Decatur County, Iowa",77,77,0,77,0,0,6936,5581,47,4755,779,1355,7334,5949,47,5099,803,1385
19055,"Delaware County, Iowa",48,48,0,48,0,0,16568,14966,333,13237,1396,1602,17088,15307,333,13569,1405,1781
19057,"Des Moines County, Iowa",2372,2175,0,1957,218,197,34469,31123,217,28147,2759,3346,39178,35424,222,31771,3431,3754
19059,"Dickinson County, Iowa",80,75,0,75,0,5,16118,14925,115,13502,1308,1193,16761,15533,117,14021,1395,1228
19061,"Dubuque County, Iowa",2457,2317,7,2088,222,140,84760,78322,699,72614,5009,6438,92279,85326,706,78588,6032,6953
19063,"Emmet County, Iowa",49,49,0,49,0,0,7818,6842,41,6004,797,976,8793,7799,198,6700,901,994
19065,"Fayette County, Iowa",169,169,0,158,11,0,18427,16202,399,14511,1292,2225,19364,17053,399,15262,1392,2311
19067,"Floyd County, Iowa",301,301,0,261,40,0,14444,12598,85,11322,1191,1846,15585,13655,104,12275,1276,1930
19069,"Franklin County, Iowa",154,64,16,48,0,90,8698,7609,179,6660,770,1089,10158,8206,205,7203,798,1952
19071,"Fremont County, Iowa",45,45,0,45,0,0,6528,5883,120,5242,521,645,6845,6160,120,5512,528,685
19073,"Greene County, Iowa",2,0,0,0,0,2,8472,7665,149,6537,979,807,8903,8021,154,6888,979,882
19075,"Grundy County, Iowa",84,80,0,80,0,4,11844,10705,109,9884,712,1139,12198,11044,109,10199,736,1154
19077,"Guthrie County, Iowa",34,1,0,1,0,33,10034,8936,168,7922,846,1098,10500,9344,168,8293,883,1156
19079,"Hamilton County, Iowa",167,46,0,43,3,121,13425,12036,85,10542,1409,1389,14994,13348,85,11609,1654,1646
19081,"Hancock County, Iowa",46,31,0,31,0,15,10120,9090,61,7578,1451,1030,10765,9595,61,7985,1549,1170
19083,"Hardin County, Iowa",129,129,0,123,6,0,15260,13193,215,11716,1262,2067,16360,13947,219,12435,1293,2413
19085,"Harrison County, Iowa",19,19,0,19,0,0,13423,11956,194,10376,1386,1467,13909,12419,194,10778,1447,1490
19087,"Henry County, Iowa",245,201,0,134,67,44,16463,14598,112,13005,1481,1865,18421,16348,112,14638,1598,2073
19089,"Howard County, Iowa",65,61,0,61,0,4,8782,7640,52,6858,730,1142,9071,7907,52,7074,781,1164
19091,"Humboldt County, Iowa",14,14,0,14,0,0,8917,7907,86,7247,574,1010,9476,8250,86,7530,634,1226
19093,"Ida County, Iowa",6,6,0,5,1,0,6559,5722,43,5306,373,837,6838,5986,43,5555,388,852
19095,"Iowa County, Iowa",113,113,0,91,22,0,15207,13807,299,11897,1611,1400,15877,14460,299,12375,1786,1417
19097,"Jackson County, Iowa",107,79,0,78,1,28,18343,15803,122,14122,1559,2540,19169,16506,122,14761,1623,2663
19099,"Jasper County, Iowa",309,178,0,141,37,131,33377,30475,824,26301,3350,2902,34987,31778,826,27320,3632,3209
19101,"Jefferson County, Iowa",926,911,0,911,0,15,13965,12711,113,11683,915,1254,16465,15196,113,13941,1142,1269
19103,"Johnson County, Iowa",8761,8034,0,7463,571,727,108278,103383,423,97594,5366,4895,136150,129867,450,121895,7522,6283
19105,"Jones County, Iowa",217,217,0,217,0,0,18404,16271,175,14244,1852,2133,19153,17008,175,14900,1933,2145
19107,"Keokuk County, Iowa",13,13,0,13,0,0,9751,8392,64,7456,872,1359,10076,8668,64,7690,914,1408
19109,"Kossuth County, Iowa",117,93,0,87,6,24,14197,12634,88,11243,1303,1563,14866,13266,101,11770,1395,1600
19111,"Lee County, Iowa",662,622,0,432,190,40,30891,27031,236,23949,2846,3860,33780,29774,236,26215,3323,4006
19113,"Linn County, Iowa",10583,9215,0,7656,1559,1368,187248,175191,1400,161490,12301,12057,215129,200830,1614,184035,15181,14299
19115,"Louisa County, Iowa",115,91,0,91,0,24,8705,7834,74,7204,556,871,11103,9813,74,9096,643,1290
19117,"Lucas County, Iowa",2,2,0,0,2,0,8397,7562,41,6692,829,835,8465,7619,41,6723,855,846
19119,"Lyon County, Iowa",4,4,0,4,0,0,11134,10332,66,9372,894,802,11583,10766,66,9725,975,817
19121,"Madison County, Iowa",36,36,0,36,0,0,14899,13564,87,12092,1385,1335,15517,14182,87,12672,1423,1335
19123,"Mahaska County, Iowa",222,222,0,186,36,0,20370,18431,182,16910,1339,1939,21610,19585,182,17879,1524,2025
19125,"Marion County, Iowa",190,190,0,190,0,0,29792,27134,292,24431,2411,2658,31392,28398,292,25569,2537,2994
19127,"Marshall County, Iowa",413,284,0,147,137,129,28401,25438,403,22171,2864,2963,39468,35201,468,29965,4768,4267
19129,"Mills County, Iowa",88,88,0,88,0,0,13593,12430,127,11242,1061,1163,14345,13142,127,11938,1077,1203
19131,"Mitchell County, Iowa",5,5,0,0,5,0,10110,8627,49,7865,713,1483,10429,8914,49,8103,762,1515
19133,"Monona County, Iowa",4,4,0,4,0,0,8205,7154,125,6346,683,1051,8626,7543,125,6725,693,1083
19135,"Monroe County, Iowa",3,3,0,0,3,0,7267,6403,67,5361,975,864,7777,6913,67,5868,978,864
19137,"Montgomery County, Iowa",0,0,0,0,0,0,9432,8310,66,7235,1009,1122,10029,8838,66,7731,1041,1191
19139,"Muscatine County, Iowa",843,692,0,285,407,151,32878,29546,273,27166,2107,3332,42349,37712,273,33871,3568,4637
19141,"O'Brien County, Iowa",118,89,0,83,6,29,12618,11449,148,9963,1338,1169,13549,12312,148,10767,1397,1237
19143,"Osceola County, Iowa",77,77,0,66,11,0,5455,4899,45,4587,267,556,6045,5479,45,5119,315,566
19145,"Page County, Iowa",138,126,0,97,29,12,13305,11946,132,10619,1195,1359,14344,12952,132,11502,1318,1392
19147,"Palo Alto County, Iowa",163,163,0,163,0,0,8276,7507,27,6723,757,769,8753,7981,27,7090,864,772
19149,"Plymouth County, Iowa",108,108,0,98,10,0,22868,20992,109,19265,1618,1876,24660,22531,130,20626,1775,2129
19151,"Pocahontas County, Iowa",120,120,0,117,3,0,6374,5678,54,5127,497,696,6815,6038,54,5463,521,777
19153,"Polk County, Iowa",29320,26161,150,21985,4026,3159,359970,340677,2354,313964,24359,19293,458412,432104,2982,392698,36424,26308
19155,"Pottawattamie County, Iowa",989,747,0,581,166,242,80646,72915,659,65407,6849,7731,90921,81875,676,72675,8524,9046
19157,"Poweshiek County, Iowa",241,241,0,241,0,0,15814,14331,370,12351,1610,1483,16689,15145,370,13112,1663,1544
19159,"Ringgold County, Iowa",3,3,0,0,3,0,4583,3862,75,3350,437,721,4774,4034,76,3499,459,740
19161,"Sac County, Iowa",72,72,0,72,0,0,9307,8374,74,7459,841,933,9736,8791,106,7802,883,945
19163,"Scott County, Iowa",13118,10427,0,9427,1000,2691,135709,122649,967,113610,8072,13060,168236,150751,1105,138000,11646,17485
19165,"Shelby County, Iowa",50,40,0,40,0,10,10975,9644,120,8765,759,1331,11549,10169,120,9273,776,1380
19167,"Sioux County, Iowa",70,69,0,64,5,1,28252,26360,166,25193,1001,1892,32360,30008,202,28541,1265,2352
19169,"Story County, Iowa",1631,1572,0,1340,232,59,71932,69214,441,61300,7473,2718,85966,82976,452,72908,9616,2990
19171,"Tama County, Iowa",88,88,0,88,0,0,13856,12671,159,10726,1786,1185,16849,15453,164,13115,2174,1396
19173,"Taylor County, Iowa",20,20,0,20,0,0,5540,4848,48,4259,541,692,6115,5355,50,4666,639,760
19175,"Union County, Iowa",137,122,0,122,0,15,11552,10157,178,8879,1100,1395,12189,10712,178,9434,1100,1477
19177,"Van Buren County, Iowa",40,40,0,40,0,0,6985,5517,144,4549,824,1468,7212,5736,144,4738,854,1476
19179,"Wapello County, Iowa",988,828,0,724,104,160,28920,25460,226,22683,2551,3460,34496,30154,226,26636,3292,4342
19181,"Warren County, Iowa",143,143,0,119,24,0,44343,41781,278,38432,3071,2562,46766,44107,278,40652,3177,2659
19183,"Washington County, Iowa",200,171,0,144,27,29,19886,17783,292,15889,1602,2103,21753,19604,333,17232,2039,2149
19185,"Wayne County, Iowa",34,24,0,24,0,10,6088,4677,28,4127,522,1411,6289,4813,28,4250,535,1476
19187,"Webster County, Iowa",1145,875,0,693,182,270,30660,27117,174,24626,2317,3543,34098,30118,176,27170,2772,3980
19189,"Winnebago County, Iowa",70,57,0,31,26,13,9249,8254,108,7231,915,995,9956,8908,108,7642,1158,1048
19191,"Winneshiek County, Iowa",82,82,0,71,11,0,17451,15778,167,14568,1043,1673,18230,16537,167,15275,1095,1693
19193,"Woodbury County, Iowa",3164,2650,0,2277,373,514,74184,66868,554,59044,7270,7316,99494,88958,871,76702,11385,10536
19195,"Worth County, Iowa",82,70,0,9,61,12,7010,6065,42,5479,544,945,7398,6396,42,5696,658,1002
19197,"Wright County, Iowa",60,60,0,60,0,0,10921,9561,277,8470,814,1360,12615,10740,321,9309,1110,1875
20001,"Allen County, Kansas",155,144,0,95,49,11,11266,9661,36,8731,894,1605,12345,10568,37,9422,1109,1777
20003,"Anderson County, Kansas",13,13,0,13,0,0,7355,6054,77,5032,945,1301,7720,6405,77,5383,945,1315
20005,"Atchison County, Kansas",474,367,0,342,25,107,13412,11778,292,10371,1115,1634,15046,13218,302,11620,1296,1828
20007,"Barber County, Kansas",31,20,0,20,0,11,4484,4032,61,3248,723,452,4855,4375,61,3405,909,480
20009,"Barton County, Kansas",337,290,0,290,0,47,21827,19524,208,16830,2486,2303,26587,23706,208,20263,3235,2881
20011,"Bourbon County, Kansas",381,221,0,173,48,160,13072,10991,91,9599,1301,2081,14337,11923,91,10292,1540,2414
20013,"Brown County, Kansas",101,83,0,75,8,18,8025,6928,91,6157,680,1097,9617,8337,97,7368,872,1280
20015,"Butler County, Kansas",649,554,0,520,34,95,57832,53709,257,49745,3707,4123,63593,59204,259,54835,4110,4389
20017,"Chase County, Kansas",22,22,0,22,0,0,2376,2035,10,1876,149,341,2569,2191,10,2021,160,378
20019,"Chautauqua County, Kansas",11,11,0,11,0,0,2905,2451,6,2081,364,454,3360,2818,6,2364,448,542
20021,"Cherokee County, Kansas",83,46,0,46,0,37,17931,16108,311,13349,2448,1823,20262,18006,334,15089,2583,2256
20023,"Cheyenne County, Kansas",0,0,0,0,0,0,2381,2098,15,1952,131,283,2642,2318,15,2168,135,324
20025,"Clark County, Kansas",24,24,0,21,3,0,1679,1474,8,1217,249,205,2031,1698,20,1384,294,333
20027,"Clay County, Kansas",52,10,0,10,0,42,7600,6490,53,5607,830,1110,8048,6831,53,5933,845,1217
20029,"Cloud County, Kansas",31,16,0,16,0,15,8218,7237,68,5938,1231,981,8795,7786,68,6422,1296,1009
20031,"Coffey County, Kansas",61,61,0,61,0,0,7675,7035,57,6275,703,640,8198,7532,57,6734,741,666
20033,"Comanche County, Kansas",0,0,0,0,0,0,1510,1356,2,1116,238,154,1670,1512,2,1264,246,158
20035,"Cowley County, Kansas",740,694,0,616,78,46,27231,24364,250,21294,2820,2867,33522,30137,285,26242,3610,3385
20037,"Crawford County, Kansas",822,751,0,547,204,71,32741,29845,68,26359,3418,2896,37255,33832,90,29496,4246,3423
20039,"Decatur County, Kansas",4,4,0,4,0,0,2661,2373,31,2164,178,288,2808,2469,31,2260,178,339
20041,"Dickinson County, Kansas",159,146,0,136,10,13,17174,15262,117,13401,1744,1912,18837,16731,117,14677,1937,2106
20043,"Doniphan County, Kansas",45,37,0,31,6,8,6718,5634,63,4600,971,1084,7168,6031,63,4933,1035,1137
20045,"Douglas County, Kansas",4377,4264,33,3400,831,113,87023,83846,230,78339,5277,3177,109172,105099,335,97282,7482,4073
20047,"Edwards County, Kansas",0,0,0,0,0,0,2213,1994,26,1523,445,219,2844,2466,26,1902,538,378
20049,"Elk County, Kansas",4,4,0,0,4,0,2316,2007,35,1723,249,309,2540,2149,35,1845,269,391
20051,"Ellis County, Kansas",240,212,0,201,11,28,25109,23341,83,21880,1378,1768,27680,25661,83,23841,1737,2019
20053,"Ellsworth County, Kansas",38,38,0,38,0,0,4965,4442,13,3946,483,523,5434,4853,13,4295,545,581
20055,"Finney County, Kansas",750,614,0,587,27,136,15376,13892,21,12863,1008,1484,36520,33350,169,29530,3651,3170
20057,"Ford County, Kansas",675,509,0,314,195,166,13668,12004,36,10629,1339,1664,33978,29589,86,25337,4166,4389
20059,"Franklin County, Kansas",332,229,0,203,26,103,22869,20413,98,17324,2991,2456,25015,22353,103,18983,3267,2662
20061,"Geary County, Kansas",5993,5716,39,5110,567,277,19824,18666,88,17737,841,1158,34820,33041,176,30787,2078,1779
20063,"Gove County, Kansas",2,2,0,2,0,0,2447,2211,18,1984,209,236,2584,2342,18,2085,239,242
20065,"Graham County, Kansas",91,83,0,30,53,8,2250,1965,29,1782,154,285,2517,2219,29,1975,215,298
20067,"Grant County, Kansas",0,0,0,0,0,0,3941,3641,2,3243,396,300,7645,7071,5,6328,738,574
20069,"Gray County, Kansas",37,37,0,37,0,0,4989,4730,25,4045,660,259,5919,5531,25,4582,924,388
20071,"Greeley County, Kansas",10,10,0,0,10,0,877,782,0,748,34,95,1180,1063,0,961,102,117
20073,"Greenwood County, Kansas",0,0,0,0,0,0,5689,4658,31,3877,750,1031,6142,5000,41,4092,867,1142
20075,"Hamilton County, Kansas",86,86,0,74,12,0,1671,1541,15,1370,156,130,2621,2346,29,2056,261,275
20077,"Harper County, Kansas",9,9,0,9,0,0,5046,4502,45,3840,617,544,5595,4953,45,4226,682,642
20079,"Harvey County, Kansas",585,447,0,383,64,138,27812,25523,175,23230,2118,2289,33311,29621,175,26902,2544,3690
20081,"Haskell County, Kansas",0,0,0,0,0,0,2804,2532,52,2187,293,272,4037,3587,52,3116,419,450
20083,"Hodgeman County, Kansas",0,0,0,0,0,0,1614,1466,10,1310,146,148,1840,1663,10,1467,186,177
20085,"Jackson County, Kansas",76,51,0,34,17,25,11114,9900,126,9052,722,1214,13181,11739,129,10622,988,1442
20087,"Jefferson County, Kansas",67,43,0,31,12,24,17497,15888,179,14361,1348,1609,18606,16884,187,15083,1614,1722
20089,"Jewell County, Kansas",6,6,0,6,0,0,2810,2372,0,2084,288,438,2932,2489,0,2171,318,443
20091,"Johnson County, Kansas",26052,24423,56,23352,1015,1629,462287,449230,1244,432725,15261,13057,573990,556117,1355,535565,19197,17873
20093,"Kearny County, Kansas",23,23,0,23,0,0,2528,2303,11,1983,309,225,3863,3565,11,3101,453,298
20095,"Kingman County, Kansas",18,18,0,18,0,0,6982,6292,71,5369,852,690,7439,6733,71,5728,934,706
20097,"Kiowa County, Kansas",13,13,0,13,0,0,2110,1880,23,1576,281,230,2339,2097,23,1762,312,242
20099,"Labette County, Kansas",732,594,0,534,60,138,17118,14926,142,13173,1611,2192,20014,17398,153,15335,1910,2616
20101,"Lane County, Kansas",0,0,0,0,0,0,1536,1413,11,1275,127,123,1694,1543,11,1372,160,151
20103,"Leavenworth County, Kansas",5279,4888,0,4330,558,391,59946,56864,424,51182,5258,3082,73220,69403,442,62217,6744,3817
20105,"Lincoln County, Kansas",20,20,0,20,0,0,2922,2497,11,2110,376,425,3055,2630,11,2235,384,425
20107,"Linn County, Kansas",78,76,0,68,8,2,8954,7359,104,5575,1680,1595,9541,7932,108,5946,1878,1609
20109,"Logan County, Kansas",0,0,0,0,0,0,2492,2275,17,2120,138,217,2752,2502,17,2281,204,250
20111,"Lyon County, Kansas",676,607,0,495,112,69,22706,20817,112,18971,1734,1889,31938,29549,112,26964,2473,2389
20113,"McPherson County, Kansas",198,118,0,118,0,80,25385,23479,83,21420,1976,1906,27492,25348,83,23221,2044,2144
20115,"Marion County, Kansas",62,62,0,62,0,0,10582,9171,82,8026,1063,1411,11303,9807,82,8604,1121,1496
20117,"Marshall County, Kansas",24,23,0,23,0,1,9204,8161,48,7179,934,1043,9689,8617,49,7550,1018,1072
20119,"Meade County, Kansas",16,16,0,16,0,0,3346,3009,0,2654,355,337,4171,3720,0,3300,420,451
20121,"Miami County, Kansas",375,289,0,289,0,86,30205,28059,407,23053,4599,2146,32270,29975,449,24883,4643,2295
20123,"Mitchell County, Kansas",22,22,0,1,21,0,5747,5147,25,4669,453,600,5966,5366,25,4765,576,600
20125,"Montgomery County, Kansas",1637,1321,38,1128,155,316,26177,23168,97,20117,2954,3009,32574,28906,142,24545,4219,3668
20127,"Morris County, Kansas",0,0,0,0,0,0,5110,4608,75,4206,327,502,5528,4970,84,4530,356,558
20129,"Morton County, Kansas",15,15,0,15,0,0,2048,1758,0,1585,173,290,2847,2501,0,2109,392,346
20131,"Nemaha County, Kansas",41,38,0,27,11,3,9374,8390,92,7359,939,984,9780,8780,92,7715,973,1000
20133,"Neosho County, Kansas",160,143,0,127,16,17,14318,12191,87,10571,1533,2127,15765,13382,89,11349,1944,2383
20135,"Ness County, Kansas",5,5,0,5,0,0,2608,2259,3,2094,162,349,2950,2581,3,2283,295,369
20137,"Norton County, Kansas",0,0,0,0,0,0,4524,3716,76,3432,208,808,4706,3862,76,3578,208,844
20139,"Osage County, Kansas",86,64,0,5,59,22,14727,12982,280,11116,1586,1745,15696,13870,280,11847,1743,1826
20141,"Osborne County, Kansas",15,15,0,15,0,0,3392,2971,15,2615,341,421,3579,3158,19,2775,364,421
20143,"Ottawa County, Kansas",40,0,0,0,0,40,5539,4698,132,3805,761,841,5869,4976,132,4075,769,893
20145,"Pawnee County, Kansas",83,51,0,44,7,32,5043,4387,5,3863,519,656,5683,4801,5,4221,575,882
20147,"Phillips County, Kansas",12,12,0,12,0,0,5043,4547,13,4098,436,496,5345,4826,13,4321,492,519
20149,"Pottawatomie County, Kansas",138,138,0,129,9,0,20517,19123,54,17511,1558,1394,22853,21395,54,19612,1729,1458
20151,"Pratt County, Kansas",0,0,0,0,0,0,8580,7524,34,6599,891,1056,9273,8089,34,7140,915,1184
20153,"Rawlins County, Kansas",10,10,0,10,0,0,2272,2013,10,1852,151,259,2481,2208,10,2046,152,273
20155,"Reno County, Kansas",1101,854,0,816,38,247,52100,46327,350,41358,4619,5773,60572,53756,383,48085,5288,6816
20157,"Republic County, Kansas",10,0,0,0,0,10,4425,3735,24,3070,641,690,4605,3878,38,3178,662,727
20159,"Rice County, Kansas",95,77,0,72,5,18,7879,7007,31,6282,694,872,9224,8269,46,7443,780,955
20161,"Riley County, Kansas",4026,3817,224,3137,456,209,50936,48810,48,45801,2961,2126,65709,63116,272,57979,4865,2593
20163,"Rooks County, Kansas",24,24,0,24,0,0,4712,4229,24,3820,385,483,4949,4444,24,4032,388,505
20165,"Rush County, Kansas",0,0,0,0,0,0,2877,2485,4,2178,303,392,3051,2650,4,2295,351,401
20167,"Russell County, Kansas",82,22,0,22,0,60,6408,5611,21,5035,555,797,6865,5877,28,5273,576,988
20169,"Saline County, Kansas",1598,1396,0,1177,219,202,43378,39044,168,34637,4239,4334,53835,48445,171,42409,5865,5390
20171,"Scott County, Kansas",0,0,0,0,0,0,3894,3673,0,3538,135,221,4896,4675,0,4540,135,221
20173,"Sedgwick County, Kansas",45296,36548,128,28645,7775,8748,345813,317669,1806,294495,21368,28144,504001,453816,2363,410123,41330,50185
20175,"Seward County, Kansas",1010,895,0,438,457,115,6922,6172,124,5554,494,750,22453,19670,134,17657,1879,2783
20177,"Shawnee County, Kansas",13454,10140,26,7673,2441,3314,129814,119435,697,105761,12977,10379,173603,155744,955,134308,20481,17859
20179,"Sheridan County, Kansas",8,8,0,8,0,0,2321,2074,39,1837,198,247,2471,2224,39,1927,258,247
20181,"Sherman County, Kansas",10,10,0,10,0,0,4993,4552,121,4183,248,441,5866,5365,128,4966,271,501
20183,"Smith County, Kansas",14,14,0,14,0,0,3447,3025,23,2820,182,422,3627,3197,23,2969,205,430
20185,"Stafford County, Kansas",28,28,0,28,0,0,3434,3080,24,2559,497,354,4126,3717,29,2965,723,409
20187,"Stanton County, Kansas",0,0,0,0,0,0,1229,1137,0,920,217,92,2079,1880,0,1503,377,199
20189,"Stevens County, Kansas",0,0,0,0,0,0,3478,3321,9,2523,789,157,5643,5378,9,4081,1288,265
20191,"Sumner County, Kansas",187,111,0,94,17,76,20571,18364,163,16496,1705,2207,22838,20374,163,17950,2261,2464
20193,"Thomas County, Kansas",89,89,0,89,0,0,6882,6614,60,6142,412,268,7491,7180,60,6610,510,311
20195,"Trego County, Kansas",0,0,0,0,0,0,2676,2521,0,2297,224,155,2814,2659,0,2427,232,155
20197,"Wabaunsee County, Kansas",22,16,0,16,0,6,6364,5637,69,5074,494,727,6822,6079,69,5426,584,743
20199,"Wallace County, Kansas",0,0,0,0,0,0,1470,1284,0,1198,86,186,1571,1382,0,1263,119,189
20201,"Washington County, Kansas",10,10,0,10,0,0,5114,4441,39,3852,550,673,5418,4663,40,4024,599,755
20203,"Wichita County, Kansas",15,15,0,15,0,0,1475,1302,6,1103,193,173,2130,1892,6,1612,274,238
20205,"Wilson County, Kansas",43,17,0,17,0,26,8056,6744,221,5412,1111,1312,8722,7249,224,5882,1143,1473
20207,"Woodson County, Kansas",34,34,0,34,0,0,2952,2421,47,1928,446,531,3169,2590,47,2083,460,579
20209,"Wyandotte County, Kansas",37332,31071,147,23885,7039,6261,67140,60459,402,52636,7421,6681,161887,142994,617,116684,25693,18893
21001,"Adair County, Kentucky",556,454,0,454,0,102,16956,13926,192,11932,1802,3030,18005,14776,192,12653,1931,3229
21003,"Allen County, Kentucky",388,369,0,207,162,19,19468,15627,131,12879,2617,3841,20412,16415,131,13368,2916,3997
21005,"Anderson County, Kentucky",511,428,0,322,106,83,20651,18833,140,15874,2819,1818,21915,19972,140,16787,3045,1943
21007,"Ballard County, Kentucky",307,233,0,138,95,74,7476,6645,40,6008,597,831,8034,7086,40,6350,696,948
21009,"Barren County, Kentucky",1636,1181,0,853,328,455,38701,33055,231,30184,2640,5646,42669,36374,231,32738,3405,6295
21011,"Bath County, Kentucky",116,58,10,48,0,58,11542,9413,62,8205,1146,2129,12092,9806,72,8573,1161,2286
21013,"Bell County, Kentucky",707,428,0,385,43,279,25237,19115,31,16435,2649,6122,26495,20056,31,17065,2960,6439
21015,"Boone County, Kentucky",3859,3700,0,3452,248,159,112101,107125,439,102355,4331,4976,126649,120971,439,115062,5470,5678
21017,"Bourbon County, Kentucky",1433,1126,52,710,364,307,16840,14746,123,12249,2374,2094,19783,17133,175,13644,3314,2650
21019,"Boyd County, Kentucky",597,578,0,459,119,19,43963,40082,261,34971,4850,3881,46425,42407,288,37133,4986,4018
21021,"Boyle County, Kentucky",1648,1370,6,1114,250,278,23590,20911,64,18979,1868,2679,26934,23680,93,21200,2387,3254
21023,"Bracken County, Kentucky",0,0,0,0,0,0,8001,6774,151,5658,965,1227,8296,7058,151,5838,1069,1238
21025,"Breathitt County, Kentucky",10,10,0,10,0,0,12668,9594,115,7830,1649,3074,12927,9824,115,8060,1649,3103
21027,"Breckinridge County, Kentucky",313,216,0,125,91,97,18652,15262,121,13214,1927,3390,19681,16140,121,13922,2097,3541
21029,"Bullitt County, Kentucky",508,506,0,320,186,2,74336,68236,622,62189,5425,6100,78297,71912,622,65151,6139,6385
21031,"Butler County, Kentucky",16,16,9,7,0,0,11929,9617,150,8462,1005,2312,12521,10050,159,8886,1005,2471
21033,"Caldwell County, Kentucky",861,624,0,268,356,237,11461,9889,83,8305,1501,1572,12588,10753,83,8783,1887,1835
21035,"Calloway County, Kentucky",1088,907,0,754,153,181,31711,28546,84,24822,3640,3165,35017,31467,84,27253,4130,3550
21037,"Campbell County, Kentucky",2380,2088,23,1552,513,292,82073,75474,1481,67144,6849,6599,88392,81157,1504,71915,7738,7235
21039,"Carlisle County, Kentucky",78,45,0,22,23,33,4554,4011,6,3476,529,543,4830,4190,6,3604,580,640
21041,"Carroll County, Kentucky",231,180,0,164,16,51,9268,7643,163,5811,1669,1625,10360,8582,163,6496,1923,1778
21043,"Carter County, Kentucky",98,98,0,94,4,0,25942,21232,303,18002,2927,4710,26658,21815,303,18551,2961,4843
21045,"Casey County, Kentucky",48,37,0,37,0,11,14712,11576,110,10081,1385,3136,15398,12079,110,10448,1521,3319
21047,"Christian County, Kentucky",13825,11820,220,9228,2372,2005,43995,37634,194,32958,4482,6361,66087,57154,464,48862,7828,8933
21049,"Clark County, Kentucky",1735,1326,0,1176,150,409,32019,28823,54,25183,3586,3196,35336,31648,59,27527,4062,3688
21051,"Clay County, Kentucky",156,94,0,94,0,62,18612,15034,39,13498,1497,3578,19249,15533,39,13831,1663,3716
21053,"Clinton County, Kentucky",0,0,0,0,0,0,9711,7257,382,5990,885,2454,10049,7464,382,6197,885,2585
21055,"Crittenden County, Kentucky",115,54,0,54,0,61,8639,6704,118,5730,856,1935,8952,6914,118,5893,903,2038
21057,"Cumberland County, Kentucky",200,67,0,44,23,133,6179,4907,254,4246,407,1272,6651,5246,261,4516,469,1405
21059,"Daviess County, Kentucky",4059,3534,14,3074,446,525,85614,76892,511,69795,6586,8722,96112,86286,567,77767,7952,9826
21061,"Edmonson County, Kentucky",43,39,0,39,0,4,11364,9630,182,8742,706,1734,11674,9919,182,9003,734,1755
21063,"Elliott County, Kentucky",0,0,0,0,0,0,6276,4637,0,4207,430,1639,6294,4655,0,4225,430,1639
21065,"Estill County, Kentucky",5,5,0,5,0,0,13928,11185,191,9355,1639,2743,14255,11480,191,9532,1757,2775
21067,"Fayette County, Kentucky",43315,38190,115,31315,6760,5125,216914,205230,509,191785,12936,11684,302329,282622,697,256970,24955,19707
21069,"Fleming County, Kentucky",240,221,13,196,12,19,13923,10777,54,9743,980,3146,14481,11286,75,10180,1031,3195
21071,"Floyd County, Kentucky",92,73,0,48,25,19,35863,30353,158,26166,4029,5510,36596,30954,158,26717,4079,5642
21073,"Franklin County, Kentucky",4121,3659,0,3274,385,462,40146,36136,18,32536,3582,4010,48209,43457,18,39087,4352,4752
21075,"Fulton County, Kentucky",1457,1137,0,768,369,320,4109,3291,0,2984,307,818,5841,4697,0,3965,732,1144
21077,"Gallatin County, Kentucky",131,51,0,42,9,80,7791,6612,41,5391,1180,1179,8547,7192,41,5944,1207,1355
21079,"Garrard County, Kentucky",146,80,0,69,11,66,16124,14174,128,12656,1390,1950,17089,14979,138,13331,1510,2110
21081,"Grant County, Kentucky",157,105,0,105,0,52,22933,19867,184,16910,2773,3066,24386,21108,184,17775,3149,3278
21083,"Graves County, Kentucky",1564,1216,0,919,297,348,32029,27288,106,24257,2925,4741,36628,31230,192,27212,3826,5398
21085,"Grayson County, Kentucky",331,327,0,298,29,4,24607,21137,185,16465,4487,3470,25807,22290,185,17466,4639,3517
21087,"Green County, Kentucky",335,244,0,244,0,91,10296,8409,120,7077,1212,1887,10911,8933,120,7601,1212,1978
21089,"Greenup County, Kentucky",275,201,14,166,21,74,34302,31130,313,27593,3224,3172,35604,32272,327,28598,3347,3332
21091,"Hancock County, Kentucky",106,59,0,43,16,47,8235,7054,56,6501,497,1181,8586,7323,56,6749,518,1263
21093,"Hardin County, Kentucky",11885,10980,0,9501,1479,905,80271,74174,785,66430,6959,6097,104902,97180,808,86415,9957,7722
21095,"Harlan County, Kentucky",671,495,0,388,107,176,25599,19836,77,16720,3039,5763,26842,20862,83,17595,3184,5980
21097,"Harrison County, Kentucky",251,235,0,222,13,16,17172,14223,176,11512,2535,2949,18266,15115,176,12114,2825,3151
21099,"Hart County, Kentucky",759,588,55,343,190,171,16778,12844,257,11462,1125,3934,18265,13898,312,12207,1379,4367
21101,"Henderson County, Kentucky",3195,2037,46,1597,394,1158,39204,35047,123,31383,3541,4157,45002,39257,190,34742,4325,5745
21103,"Henry County, Kentucky",545,452,0,343,109,93,14314,12528,19,10241,2268,1786,15595,13610,19,11138,2453,1985
21105,"Hickman County, Kentucky",384,323,0,285,38,61,3887,2850,31,2321,498,1037,4463,3351,31,2768,552,1112
21107,"Hopkins County, Kentucky",2752,2070,25,1822,223,682,39968,33895,473,29818,3604,6073,44978,37628,516,32947,4165,7350
21109,"Jackson County, Kentucky",8,0,0,0,0,8,13184,10571,102,8668,1801,2613,13261,10637,102,8734,1801,2624
21111,"Jefferson County, Kentucky",158508,135594,175,112853,22566,22914,512870,470861,1229,440297,29335,42009,748448,676255,1754,616453,58048,72193
21113,"Jessamine County, Kentucky",1892,1737,0,1652,85,155,44715,41558,127,38079,3352,3157,49786,46157,134,41903,4120,3629
21115,"Johnson County, Kentucky",33,33,0,0,33,0,22032,18660,114,17184,1362,3372,22519,19147,114,17548,1485,3372
21117,"Kenton County, Kentucky",7084,5510,23,4391,1096,1574,143637,134281,538,124386,9357,9356,161610,149937,576,137185,12176,11673
21119,"Knott County, Kentucky",50,50,0,21,29,0,14611,12024,327,9773,1924,2587,14993,12250,330,9945,1975,2743
21121,"Knox County, Kentucky",318,256,0,256,0,62,29615,21199,259,16479,4461,8416,30721,22088,259,17318,4511,8633
21123,"Larue County, Kentucky",476,441,0,431,10,35,12696,11347,132,9658,1557,1349,13826,12369,132,10473,1764,1457
21125,"Laurel County, Kentucky",392,392,0,392,0,0,56679,48299,868,43414,4017,8380,59058,50490,950,45258,4282,8568
21127,"Lawrence County, Kentucky",49,42,0,42,0,7,15312,12917,86,11495,1336,2395,15735,13286,86,11850,1350,2449
21129,"Lee County, Kentucky",50,39,0,39,0,11,5942,4422,42,3707,673,1520,6087,4552,42,3808,702,1535
21131,"Leslie County, Kentucky",0,0,0,0,0,0,10164,7874,43,6819,1012,2290,10376,8076,43,7018,1015,2300
21133,"Letcher County, Kentucky",50,50,0,50,0,0,22268,18562,166,15377,3019,3706,22771,18991,166,15789,3036,3780
21135,"Lewis County, Kentucky",47,28,0,8,20,19,13142,10572,389,9009,1174,2570,13421,10791,389,9201,1201,2630
21137,"Lincoln County, Kentucky",508,384,10,257,117,124,22818,18119,45,15758,2316,4699,24166,19183,55,16480,2648,4983
21139,"Livingston County, Kentucky",17,11,0,11,0,6,8838,7088,141,5982,965,1750,9229,7461,141,6303,1017,1768
21141,"Logan County, Kentucky",1638,737,0,595,142,901,23575,19099,80,16383,2636,4476,26519,20828,80,17940,2808,5691
21143,"Lyon County, Kentucky",128,64,0,48,16,64,6533,5334,20,4573,741,1199,6895,5621,20,4838,763,1274
21145,"McCracken County, Kentucky",6990,5220,14,4467,739,1770,53527,47261,107,42966,4188,6266,63992,55669,121,50393,5155,8323
21147,"McCreary County, Kentucky",0,0,0,0,0,0,15380,10216,330,7665,2221,5164,15797,10621,330,8010,2281,5176
21149,"McLean County, Kentucky",31,19,0,15,4,12,8925,7817,58,6391,1368,1108,9275,8127,58,6685,1384,1148
21151,"Madison County, Kentucky",3211,2943,0,2238,705,268,74018,67923,335,60258,7330,6095,81844,75306,335,66349,8622,6538
21153,"Magoffin County, Kentucky",3,0,0,0,0,3,12526,10025,29,9215,781,2501,12658,10137,29,9288,820,2521
21155,"Marion County, Kentucky",1465,1035,0,724,311,430,16326,13609,141,11475,1993,2717,18484,15290,141,12635,2514,3194
21157,"Marshall County, Kentucky",120,111,0,111,0,9,29666,26567,161,24227,2179,3099,30609,27459,161,25106,2192,3150
21159,"Martin County, Kentucky",0,0,0,0,0,0,10611,8635,44,7739,852,1976,10734,8741,44,7845,852,1993
21161,"Mason County, Kentucky",958,718,0,631,87,240,15116,12351,74,11047,1230,2765,16879,13808,74,12400,1334,3071
21163,"Meade County, Kentucky",926,842,0,796,46,84,25248,23009,337,21268,1404,2239,28219,25786,337,23950,1499,2433
21165,"Menifee County, Kentucky",0,0,0,0,0,0,6160,5041,102,4444,495,1119,6296,5146,102,4549,495,1150
21167,"Mercer County, Kentucky",870,456,0,417,39,414,19344,16479,100,14922,1457,2865,21228,17674,100,16002,1572,3554
21169,"Metcalfe County, Kentucky",58,23,0,23,0,35,9389,7914,14,7095,805,1475,9861,8261,14,7425,822,1600
21171,"Monroe County, Kentucky",257,257,0,236,21,0,9833,7553,302,6510,741,2280,10497,8187,302,7105,780,2310
21173,"Montgomery County, Kentucky",713,601,0,445,156,112,25318,22288,172,18986,3130,3030,27177,23820,172,20324,3324,3357
21175,"Morgan County, Kentucky",52,52,0,52,0,0,11237,8919,26,8243,650,2318,11636,9174,26,8498,650,2462
21177,"Muhlenberg County, Kentucky",1210,1138,0,1083,55,72,27975,22144,268,19457,2419,5831,30053,24115,268,21220,2627,5938
21179,"Nelson County, Kentucky",2337,2100,17,1891,192,237,40401,36534,251,32843,3440,3867,44563,40061,268,36109,3684,4502
21181,"Nicholas County, Kentucky",87,87,0,84,3,0,6683,5101,139,4194,768,1582,6959,5343,139,4376,828,1616
21183,"Ohio County, Kentucky",484,431,0,375,56,53,22436,19250,202,16501,2547,3186,23759,20089,206,17239,2644,3670
21185,"Oldham County, Kentucky",1463,1397,0,1251,146,66,54272,52687,138,50490,2059,1585,60586,58703,141,55636,2926,1883
21187,"Owen County, Kentucky",186,176,0,84,92,10,10090,8237,0,6521,1716,1853,10628,8595,0,6706,1889,2033
21189,"Owsley County, Kentucky",180,180,0,180,0,0,4167,3252,0,2757,495,915,4422,3492,0,2960,532,930
21191,"Pendleton County, Kentucky",109,70,0,70,0,39,13809,11675,224,9732,1719,2134,14284,12083,224,10124,1735,2201
21193,"Perry County, Kentucky",379,321,0,285,36,58,25558,21674,63,19794,1817,3884,26680,22680,63,20654,1963,4000
21195,"Pike County, Kentucky",435,377,0,272,105,58,58612,50091,171,43568,6352,8521,60395,51642,171,44967,6504,8753
21197,"Powell County, Kentucky",22,22,0,22,0,0,11642,9040,108,7200,1732,2602,12091,9438,108,7487,1843,2653
21199,"Pulaski County, Kentucky",543,443,9,381,53,100,59408,49225,369,42719,6137,10183,62995,52356,378,45336,6642,10639
21201,"Robertson County, Kentucky",40,40,0,0,40,0,1983,1378,48,939,391,605,2099,1478,48,951,479,621
21203,"Rockcastle County, Kentucky",12,12,0,12,0,0,16097,13233,189,11120,1924,2864,16489,13587,189,11470,1928,2902
21205,"Rowan County, Kentucky",66,66,0,66,0,0,20578,18510,80,17043,1387,2068,21466,19398,80,17914,1404,2068
21207,"Russell County, Kentucky",74,68,14,54,0,6,16478,12815,319,11164,1332,3663,17525,13592,344,11602,1646,3933
21209,"Scott County, Kentucky",2331,2008,0,1696,312,323,44444,42183,232,38478,3473,2261,50938,48003,232,43373,4398,2935
21211,"Shelby County, Kentucky",2818,2015,14,1905,96,803,35697,32836,171,29556,3109,2861,44184,39888,222,35481,4185,4296
21213,"Simpson County, Kentucky",1612,1306,0,1306,0,306,15020,12500,83,10970,1447,2520,17513,14517,83,12927,1507,2996
21215,"Spencer County, Kentucky",176,151,0,115,36,25,16899,15544,33,14423,1088,1355,17887,16401,33,15110,1258,1486
21217,"Taylor County, Kentucky",1029,875,22,805,48,154,22062,18729,147,17106,1476,3333,24249,20621,169,18857,1595,3628
21219,"Todd County, Kentucky",921,604,0,457,147,317,10510,7829,112,6214,1503,2681,12190,9007,112,7080,1815,3183
21221,"Trigg County, Kentucky",1207,862,0,754,108,345,12564,10008,144,8774,1090,2556,14186,11285,144,9943,1198,2901
21223,"Trimble County, Kentucky",0,0,0,0,0,0,8164,7295,0,5770,1525,869,8641,7764,0,6191,1573,877
21225,"Union County, Kentucky",1088,880,0,718,162,208,11698,10140,32,8701,1407,1558,13283,11475,32,9820,1623,1808
21227,"Warren County, Kentucky",10628,9272,0,8104,1168,1356,92804,85500,382,78313,6805,7304,116663,106852,382,96757,9713,9811
21229,"Washington County, Kentucky",567,420,0,343,77,147,10171,8434,153,6979,1302,1737,11561,9673,153,8045,1475,1888
21231,"Wayne County, Kentucky",278,115,0,115,0,163,19113,13810,9,12287,1514,5303,20408,14443,9,12867,1567,5965
21233,"Webster County, Kentucky",466,278,0,191,87,188,11386,9622,166,7364,2092,1764,12801,10577,166,8171,2240,2224
21235,"Whitley County, Kentucky",254,254,0,208,46,0,33102,25011,91,20927,3993,8091,34174,25954,91,21720,4143,8220
21237,"Wolfe County, Kentucky",0,0,0,0,0,0,7016,5095,56,4368,671,1921,7119,5172,56,4419,697,1947
21239,"Woodford County, Kentucky",1089,909,0,595,314,180,22097,20765,138,19160,1467,1332,25483,23628,138,21327,2163,1855
22001,"Acadia Parish, Louisiana",10686,8385,126,6553,1706,2301,47883,41481,149,36471,4861,6402,61536,52431,275,44960,7196,9105
22003,"Allen Parish, Louisiana",2818,2400,11,1794,595,418,17057,14906,24,12792,2090,2151,21252,18331,35,15429,2867,2921
22005,"Ascension Parish, Louisiana",25704,22670,252,19160,3258,3034,82192,78297,194,73848,4255,3895,118282,111080,446,102398,8236,7202
22007,"Assumption Parish, Louisiana",6743,4724,0,3775,949,2019,14899,13080,102,11739,1239,1819,22657,18731,186,16110,2435,3926
22009,"Avoyelles Parish, Louisiana",10172,7856,84,5673,2099,2316,25511,21060,398,18082,2580,4451,37387,30389,482,24862,5045,6998
22011,"Beauregard Parish, Louisiana",4532,3699,5,3004,690,833,28991,26216,251,21766,4199,2775,36196,31844,280,26541,5023,4352
22013,"Bienville Parish, Louisiana",5577,3955,193,3097,665,1622,7314,6251,41,5594,616,1063,13477,10665,234,9059,1372,2812
22015,"Bossier Parish, Louisiana",26524,20071,295,12846,6930,6453,82874,76640,554,65447,10639,6234,122177,108289,1049,87102,20138,13888
22017,"Caddo Parish, Louisiana",119197,93853,435,76915,16503,25344,112209,102085,889,89202,11994,10124,246073,209294,1324,178230,29740,36779
22019,"Calcasieu Parish, Louisiana",47642,39500,22,30862,8616,8142,133630,122326,455,106728,15143,11304,195140,174697,586,147710,26401,20443
22021,"Caldwell Parish, Louisiana",1329,1014,10,926,78,315,7732,6042,45,5257,740,1690,9434,7250,55,6368,827,2184
22023,"Cameron Parish, Louisiana",184,133,0,133,0,51,6206,5630,9,4585,1036,576,6788,5953,9,4867,1077,835
22025,"Catahoula Parish, Louisiana",2544,1507,28,1096,383,1037,6363,4943,9,4193,741,1420,9017,6525,37,5348,1140,2492
22027,"Claiborne Parish, Louisiana",7279,5157,28,3255,1874,2122,6618,5509,48,4004,1457,1109,14313,10996,76,7519,3401,3317
22029,"Concordia Parish, Louisiana",7129,4718,0,4266,452,2411,10676,8440,72,7204,1164,2236,18143,13339,72,11651,1616,4804
22031,"De Soto Parish, Louisiana",9860,7375,46,5669,1660,2485,15709,13642,144,12261,1237,2067,26919,22186,206,18856,3124,4733
22033,"East Baton Rouge Parish, Louisiana",200011,170846,520,144974,25352,29165,196554,186070,601,173670,11799,10484,436312,393632,1196,352161,40275,42680
22035,"East Carroll Parish, Louisiana",3371,1151,19,843,289,2220,1574,1119,0,947,172,455,4991,2296,19,1816,461,2695
22037,"East Feliciana Parish, Louisiana",6328,4829,76,2611,2142,1499,9346,8237,68,6689,1480,1109,15985,13339,144,9553,3642,2646
22039,"Evangeline Parish, Louisiana",8986,5822,0,4616,1206,3164,22199,18704,8,16171,2525,3495,32166,25219,8,21361,3850,6947
22041,"Franklin Parish, Louisiana",5927,3775,0,2485,1290,2152,12736,9885,167,7379,2339,2851,18921,13777,167,9933,3677,5144
22043,"Grant Parish, Louisiana",1794,1378,0,1127,251,416,16407,13784,40,11169,2575,2623,18886,15733,40,12840,2853,3153
22045,"Iberia Parish, Louisiana",22721,18445,27,14576,3842,4276,43049,37770,89,33939,3742,5279,72481,62255,122,53397,8736,10226
22047,"Iberville Parish, Louisiana",13954,11143,38,8534,2571,2811,14574,13024,0,11752,1272,1550,29485,25075,38,21111,3926,4410
22049,"Jackson Parish, Louisiana",4133,3215,0,2709,506,918,10126,8415,37,7713,665,1711,14698,11912,37,10690,1185,2786
22051,"Jefferson Parish, Louisiana",114664,94839,443,77073,17323,19825,231697,210646,954,193780,15912,21051,433505,380874,1552,334916,44406,52631
22053,"Jefferson Davis Parish, Louisiana",4980,3804,17,2512,1275,1176,24304,20920,145,18472,2303,3384,30900,26187,162,22232,3793,4713
22055,"Lafayette Parish, Louisiana",59615,50477,145,44364,5968,9138,154948,146035,120,137382,8533,8913,233286,213635,265,197307,16063,19651
22057,"Lafourche Parish, Louisiana",12030,10098,0,8289,1809,1932,74316,66337,184,59701,6452,7979,96083,84726,184,74907,9635,11357
22059,"LaSalle Parish, Louisiana",1237,924,0,844,80,313,11904,9902,48,8753,1101,2002,13520,11189,48,9872,1269,2331
22061,"Lincoln Parish, Louisiana",17782,14901,121,13255,1525,2881,23697,21959,152,20241,1566,1738,44177,39359,281,35774,3304,4818
22063,"Livingston Parish, Louisiana",8058,7027,171,6162,694,1031,120367,111316,414,97215,13687,9051,136075,125635,603,109312,15720,10440
22065,"Madison Parish, Louisiana",6258,4024,245,3027,752,2234,3364,2534,30,1975,529,830,9889,6815,275,5206,1334,3074
22067,"Morehouse Parish, Louisiana",12069,6856,174,5528,1154,5213,12701,9993,110,8734,1149,2708,25429,17351,284,14552,2515,8078
22069,"Natchitoches Parish, Louisiana",15561,9756,129,8157,1470,5805,20152,16861,243,13695,2923,3291,38210,28664,373,23555,4736,9546
22071,"Orleans Parish, Louisiana",225349,172866,1160,134566,37140,52483,113321,107708,295,99687,7726,5613,374694,312934,1536,262307,49091,61760
22073,"Ouachita Parish, Louisiana",54573,39875,290,34764,4821,14698,87590,76597,1601,67954,7042,10993,148506,121990,1891,107739,12360,26516
22075,"Plaquemines Parish, Louisiana",4737,3683,0,3177,506,1054,15063,13437,62,12714,661,1626,23011,19970,62,18217,1691,3041
22077,"Pointe Coupee Parish, Louisiana",7853,6183,0,4692,1491,1670,13374,11637,151,10374,1112,1737,22144,18559,151,15475,2933,3585
22079,"Rapides Parish, Louisiana",40868,34002,30,28662,5310,6866,78638,71370,332,66021,5017,7268,127935,112820,362,101458,11000,15115
22081,"Red River Parish, Louisiana",3193,2326,0,1986,340,867,4925,4336,142,3578,616,589,8595,7054,142,5909,1003,1541
22083,"Richland Parish, Louisiana",6934,3829,284,2542,1003,3105,11990,8556,96,7044,1416,3434,19627,13050,380,10089,2581,6577
22085,"Sabine Parish, Louisiana",3844,2583,67,1659,857,1261,16183,12834,534,10166,2134,3349,23725,18551,631,14166,3754,5174
22087,"St. Bernard Parish, Louisiana",10001,8095,27,6504,1564,1906,28448,24562,124,21416,3022,3886,44717,38105,161,32518,5426,6612
22089,"St. Charles Parish, Louisiana",13571,11279,112,8179,2988,2292,34388,32427,47,29859,2521,1961,52123,47499,159,41706,5634,4624
22091,"St. Helena Parish, Louisiana",5628,3990,0,2449,1541,1638,4544,3636,29,3027,580,908,10360,7799,29,5595,2175,2561
22093,"St. James Parish, Louisiana",10551,8810,93,7087,1630,1741,10254,9086,65,8253,768,1168,21270,18334,163,15526,2645,2936
22095,"St. John the Baptist Parish, Louisiana",23760,20040,7,15480,4553,3720,15554,14289,56,13097,1136,1265,42858,37685,63,31444,6178,5173
22097,"St. Landry Parish, Louisiana",33828,23948,345,18401,5202,9880,44938,39189,780,34983,3426,5749,82330,66108,1167,55980,8961,16222
22099,"St. Martin Parish, Louisiana",15657,12877,0,10466,2411,2780,34367,31075,495,27451,3129,3292,53332,46872,495,39996,6381,6460
22101,"St. Mary Parish, Louisiana",15983,12134,155,9740,2239,3849,29100,25828,96,23404,2328,3272,51682,43602,251,38125,5226,8080
22103,"St. Tammany Parish, Louisiana",28334,24856,0,22681,2175,3478,195604,186059,603,173988,11468,9545,246765,231769,603,215656,15510,14996
22105,"Tangipahoa Parish, Louisiana",36935,31427,44,25454,5929,5508,79596,72362,479,63806,8077,7234,125222,111458,562,96061,14835,13764
22107,"Tensas Parish, Louisiana",2638,1403,201,969,233,1235,2008,1218,4,1115,99,790,4753,2657,205,2116,336,2096
22109,"Terrebonne Parish, Louisiana",21375,18219,0,12520,5699,3156,74998,68428,420,59723,8285,6570,111651,100360,447,83119,16794,11291
22111,"Union Parish, Louisiana",5509,3533,366,1857,1310,1976,15221,12863,390,10060,2413,2358,22046,17285,805,12432,4048,4761
22113,"Vermilion Parish, Louisiana",8501,6886,0,4870,2016,1615,46470,40805,141,36948,3716,5665,59342,51312,141,44661,6510,8030
22115,"Vernon Parish, Louisiana",7143,6192,42,5273,877,951,35351,31468,281,26012,5175,3883,50093,44811,358,37680,6773,5282
22117,"Washington Parish, Louisiana",13012,9358,122,6004,3232,3654,29760,24650,314,19583,4753,5110,44594,35442,436,26646,8360,9152
22119,"Webster Parish, Louisiana",13299,7798,202,4815,2781,5501,24380,20217,152,16137,3928,4163,38987,29031,365,21904,6762,9956
22121,"West Baton Rouge Parish, Louisiana",9270,7834,0,5803,2031,1436,14312,13106,44,12176,886,1206,24685,22000,44,18854,3102,2685
22123,"West Carroll Parish, Louisiana",1442,739,11,339,389,703,8774,5784,136,4617,1031,2990,10673,6946,188,5124,1634,3727
22125,"West Feliciana Parish, Louisiana",4597,4168,0,3108,1060,429,7121,6794,14,6020,760,327,11950,11194,14,9227,1953,756
22127,"Winn Parish, Louisiana",3273,2239,0,2048,191,1034,9006,7235,80,6660,495,1771,12758,9920,80,9042,798,2838
23001,"Androscoggin County, Maine",1780,1615,0,1511,104,165,95176,87275,677,79260,7338,7901,104131,95855,703,86753,8399,8276
23003,"Aroostook County, Maine",599,559,20,518,21,40,63001,54564,498,46951,7115,8437,66617,57825,520,49758,7547,8792
23005,"Cumberland County, Maine",7773,6916,0,5809,1107,857,255347,241651,1409,226959,13283,13696,280820,265077,1420,248203,15454,15743
23007,"Franklin County, Maine",68,65,5,53,7,3,27851,25437,343,22132,2962,2414,29039,26573,348,23155,3070,2466
23009,"Hancock County, Maine",366,361,0,308,53,5,50389,46010,602,41298,4110,4379,52841,48349,605,43378,4366,4492
23011,"Kennebec County, Maine",945,629,0,629,0,316,112026,102084,863,92700,8521,9942,117553,106919,882,97241,8796,10634
23013,"Knox County, Maine",203,190,0,182,8,13,36990,34358,467,30504,3387,2632,38401,35733,475,31786,3472,2668
23015,"Lincoln County, Maine",86,86,0,86,0,0,32113,29763,524,25291,3948,2350,33352,30992,526,26437,4029,2360
23017,"Oxford County, Maine",158,158,0,146,12,0,54030,47811,548,41117,6146,6219,56467,49988,549,43150,6289,6479
23019,"Penobscot County, Maine",868,740,0,704,36,128,137300,124797,1509,111550,11738,12503,145434,132371,1538,118576,12257,13063
23021,"Piscataquis County, Maine",75,75,17,58,0,0,15956,13806,347,11082,2377,2150,16657,14493,384,11582,2527,2164
23023,"Sagadahoc County, Maine",260,219,0,219,0,41,33138,30441,111,27667,2663,2697,34929,31973,111,29141,2721,2956
23025,"Somerset County, Maine",226,226,0,196,30,0,48306,42505,579,37120,4806,5801,50292,44201,580,38533,5088,6091
23027,"Waldo County, Maine",147,145,0,141,4,2,37007,33400,368,29714,3318,3607,38528,34768,389,30791,3588,3760
23029,"Washington County, Maine",101,98,0,90,8,3,27765,23958,472,20721,2765,3807,30796,26480,489,22876,3115,4316
23031,"York County, Maine",1645,1599,0,1013,586,46,187760,175175,1331,163117,10727,12585,198351,185313,1334,171588,12391,13038
24001,"Allegany County, Maryland",1525,1369,24,1177,168,156,60785,52318,482,47089,4747,8467,64878,55998,506,50393,5099,8880
24003,"Anne Arundel County, Maryland",86031,80349,53,74311,5985,5682,384335,368821,1231,354081,13509,15514,548153,524127,1600,498061,24466,24026
24005,"Baltimore County, Maryland",225333,213729,1107,194300,18322,11604,474308,437564,2270,413550,21744,36744,807980,754401,3637,702862,47902,53579
24009,"Calvert County, Maryland",10606,9428,106,8341,981,1178,71161,68770,215,66180,2375,2391,90177,86489,412,82183,3894,3688
24011,"Caroline County, Maryland",4188,3366,0,2794,572,822,24727,22088,271,20094,1723,2639,32273,28339,271,25090,2978,3934
24013,"Carroll County, Maryland",4649,4197,8,3876,313,452,147896,139607,1173,130600,7834,8289,163754,154552,1288,144345,8919,9202
24015,"Cecil County, Maryland",6434,5916,0,5299,617,518,87029,79059,377,72152,6530,7970,100925,91821,377,83689,7755,9104
24017,"Charles County, Maryland",66131,61665,113,58283,3269,4466,66321,61531,556,58323,2652,4790,153678,143715,772,135665,7278,9963
24019,"Dorchester County, Maryland",8675,7242,35,5706,1501,1433,20357,18107,225,16078,1804,2250,31808,27912,302,23726,3884,3896
24021,"Frederick County, Maryland",21399,19758,10,18145,1603,1641,180795,170944,1219,162588,7137,9851,241378,226938,1278,214009,11651,14440
24023,"Garrett County, Maryland",13,10,0,6,4,3,28096,24460,368,21004,3088,3636,28887,25215,368,21601,3246,3672
24025,"Harford County, Maryland",33229,31989,89,28145,3755,1240,191348,180632,974,172194,7464,10716,248245,235158,1063,221186,12909,13087
24027,"Howard County, Maryland",56954,55368,52,52073,3243,1586,167957,163422,277,159806,3339,4535,310299,303257,423,294385,8449,7042
24029,"Kent County, Maryland",2676,1937,0,1563,374,739,14276,13111,137,11880,1094,1165,18030,15808,137,14080,1591,2222
24031,"Montgomery County, Maryland",185253,179628,501,165127,14000,5625,462760,449868,1402,436476,11990,12892,1030386,1000062,2634,944709,52719,30324
24033,"Prince George's County, Maryland",566050,540533,1993,492977,45563,25517,111394,104182,710,97713,5759,7212,886474,836374,3346,756246,76782,50100
24035,"Queen Anne's County, Maryland",3219,3018,0,2292,726,201,42291,39923,217,38144,1562,2368,48609,45606,308,42943,2355,3003
24037,"St. Mary's County, Maryland",15353,11121,191,8796,2134,4232,81182,74827,676,68229,5922,6355,107977,97073,873,87423,8777,10904
24039,"Somerset County, Maryland",6391,5577,27,4055,1495,814,12038,10170,153,8882,1135,1868,19771,16856,192,13850,2814,2915
24041,"Talbot County, Maryland",4254,3466,29,2770,667,788,28770,26767,160,24934,1673,2003,37055,33773,189,30934,2650,3282
24043,"Washington County, Maryland",11187,9467,35,7624,1808,1720,116638,102905,1052,91378,10475,13733,140691,124706,1093,109649,13964,15985
24045,"Wicomico County, Maryland",24956,21907,44,16805,5058,3049,62426,58494,406,51140,6948,3932,97919,90047,459,76164,13424,7872
24047,"Worcester County, Maryland",6733,4825,17,3722,1086,1908,40822,37839,424,34923,2492,2983,50781,45747,441,41446,3860,5034
24510,"Baltimore city, Maryland",376140,318193,2008,256867,59318,57947,162897,148419,786,138566,9067,14478,595456,517137,2807,439776,74554,78319
25001,"Barnstable County, Massachusetts",5647,5348,0,4573,775,299,190570,179867,1133,168447,10287,10703,211082,199376,1160,185746,12470,11706
25003,"Berkshire County, Massachusetts",2735,2379,0,1967,412,356,108857,99181,1035,92187,5959,9676,120827,109822,1047,101676,7099,11005
25005,"Bristol County, Massachusetts",19796,17924,7,15928,1989,1872,448834,407142,1609,381814,23719,41692,540870,488735,1826,453517,33392,52135
25007,"Dukes County, Massachusetts",633,550,0,421,129,83,14855,14086,48,12846,1192,769,17010,16069,67,14573,1429,941
25009,"Essex County, Massachusetts",30240,28019,129,25265,2625,2221,544481,510292,2102,486557,21633,34189,757769,704070,2544,660258,41268,53699
25011,"Franklin County, Massachusetts",774,723,1,718,4,51,63496,58142,710,53021,4411,5354,69275,63526,742,57868,4916,5749
25013,"Hampden County, Massachusetts",39598,33369,19,29562,3788,6229,289632,263193,1482,245952,15759,26439,454632,404247,1818,366859,35570,50385
25015,"Hampshire County, Massachusetts",3081,2847,61,2498,288,234,120070,113275,624,108424,4227,6795,138428,130431,715,124395,5321,7997
25017,"Middlesex County, Massachusetts",76578,72120,157,66048,5915,4458,1122707,1064814,3077,1025649,36088,57893,1523588,1444167,3715,1380908,59544,79421
25019,"Nantucket County, Massachusetts",842,792,0,665,127,50,7906,7731,20,7519,192,175,10629,10404,20,10065,319,225
25021,"Norfolk County, Massachusetts",43032,41157,135,38508,2514,1875,520536,494866,1155,476588,17123,25670,676032,645759,1502,620461,23796,30273
25023,"Plymouth County, Massachusetts",45029,41380,139,37759,3482,3649,408951,389721,1159,372089,16473,19230,497704,473042,1361,449028,22653,24662
25025,"Suffolk County, Massachusetts",170206,153298,761,133839,18698,16908,325040,302965,758,288195,14012,22075,731679,671614,1968,618567,51079,60065
25027,"Worcester County, Massachusetts",35932,33807,82,30549,3176,2125,616315,574132,2730,542943,28459,42183,789066,736871,3057,690096,43718,52195
26001,"Alcona County, Michigan",13,13,0,7,6,0,9899,8226,184,6958,1084,1673,10280,8551,190,7233,1128,1729
26003,"Alger County, Michigan",5,5,0,5,0,0,7438,6224,80,5451,693,1214,8222,6928,82,6087,759,1294
26005,"Allegan County, Michigan",1459,1118,0,909,209,341,100413,87418,1126,77416,8876,12995,112980,96926,1132,85810,9984,16054
26007,"Alpena County, Michigan",95,66,0,48,18,29,27158,23894,217,21235,2442,3264,28185,24772,217,21941,2614,3413
26009,"Antrim County, Michigan",63,47,0,30,17,16,21798,19917,233,16705,2979,1881,22884,20865,233,17337,3295,2019
26011,"Arenac County, Michigan",50,50,0,40,10,0,14289,11777,201,9624,1952,2512,15028,12380,206,10113,2061,2648
26013,"Baraga County, Michigan",30,28,0,13,15,2,5775,4934,91,4344,499,841,6711,5772,107,5105,560,939
26015,"Barry County, Michigan",252,252,15,193,44,0,55833,50962,685,45527,4750,4871,58923,53956,705,47946,5305,4967
26017,"Bay County, Michigan",1616,1404,0,1222,182,212,93903,82964,552,76065,6347,10939,103885,91748,568,84128,7052,12137
26019,"Benzie County, Michigan",18,18,0,18,0,0,16146,14798,195,13394,1209,1348,17135,15678,196,14148,1334,1457
26021,"Berrien County, Michigan",21402,17049,137,13398,3514,4353,114412,103735,1049,92218,10468,10677,150216,134181,1202,116902,16077,16035
26023,"Branch County, Michigan",120,79,0,63,16,41,38418,33187,297,29652,3238,5231,41212,35657,307,31578,3772,5555
26025,"Calhoun County, Michigan",13917,10796,58,9343,1395,3121,102176,91610,792,79770,11048,10566,130318,115509,890,100554,14065,14809
26027,"Cass County, Michigan",2385,2044,0,1490,554,341,44174,39944,406,34518,5020,4230,50983,46240,419,39377,6444,4743
26029,"Charlevoix County, Michigan",79,79,0,68,11,0,24343,22607,284,19553,2770,1736,25839,23998,286,20725,2987,1841
26031,"Cheboygan County, Michigan",130,130,0,61,69,0,23261,20265,254,17159,2852,2996,25152,21923,273,18575,3075,3229
26033,"Chippewa County, Michigan",485,433,0,275,158,52,25033,21665,339,19079,2247,3368,33893,29631,542,26082,3007,4262
26035,"Clare County, Michigan",72,55,0,41,14,17,28787,23864,333,19111,4420,4923,30137,25001,358,20086,4557,5136
26037,"Clinton County, Michigan",1181,1148,0,1056,92,33,69213,64874,717,60407,3750,4339,76581,71766,752,66863,4151,4815
26039,"Crawford County, Michigan",51,7,0,7,0,44,12982,11526,101,10154,1271,1456,13613,12102,101,10627,1374,1511
26041,"Delta County, Michigan",15,15,0,15,0,0,33488,29466,228,26696,2542,4022,35830,31579,239,28522,2818,4251
26043,"Dickinson County, Michigan",123,123,0,99,24,0,24186,21124,221,19240,1663,3062,25270,22128,221,20176,1731,3142
26045,"Eaton County, Michigan",6923,6450,12,5354,1084,473,89338,82400,573,74226,7601,6938,106888,98979,598,88395,9986,7909
26047,"Emmet County, Michigan",128,105,0,101,4,23,29749,27042,403,24028,2611,2707,32458,29547,420,26307,2820,2911
26049,"Genesee County, Michigan",80568,62402,179,46843,15380,18166,294539,266277,1647,241780,22850,28262,405427,356840,1922,312398,42520,48587
26051,"Gladwin County, Michigan",55,36,0,36,0,19,24152,18723,296,14829,3598,5429,25067,19474,296,15474,3704,5593
26053,"Gogebic County, Michigan",117,117,0,117,0,0,13171,11091,85,8532,2474,2080,14021,11815,85,9127,2603,2206
26055,"Grand Traverse County, Michigan",564,494,0,384,110,70,82520,77758,355,71385,6018,4762,88546,83301,391,75945,6965,5245
26057,"Gratiot County, Michigan",377,256,0,176,80,121,32439,28939,287,23837,4815,3500,35564,31804,287,26182,5335,3760
26059,"Hillsdale County, Michigan",213,194,0,153,41,19,42251,35436,429,30358,4649,6815,44270,37099,456,31711,4932,7171
26061,"Houghton County, Michigan",202,157,0,156,1,45,31462,28505,136,25227,3142,2957,33957,30788,136,27132,3520,3169
26063,"Huron County, Michigan",89,82,0,67,15,7,29796,25746,202,22118,3426,4050,31192,26972,206,23040,3726,4220
26065,"Ingham County, Michigan",29724,26304,0,21830,4474,3420,189560,178319,1161,161265,15893,11241,267505,249816,1254,221900,26662,17689
26067,"Ionia County, Michigan",1432,1375,0,701,674,57,54938,50552,451,43783,6318,4386,60255,55439,463,47556,7420,4816
26069,"Iosco County, Michigan",119,119,0,114,5,0,23559,20141,273,18010,1858,3418,24931,21415,279,19127,2009,3516
26071,"Iron County, Michigan",38,38,0,38,0,0,10419,8781,175,6786,1820,1638,10923,9276,180,7249,1847,1647
26073,"Isabella County, Michigan",1270,1264,27,817,420,6,55292,50907,621,39915,10371,4385,63951,58905,743,46104,12058,5046
26075,"Jackson County, Michigan",9915,8051,0,5887,2164,1864,129978,119018,918,105073,13027,10960,149481,136070,927,119186,15957,13411
26077,"Kalamazoo County, Michigan",26848,23842,87,20963,2792,3006,196482,185654,780,173344,11530,10828,251196,236284,927,218579,16778,14912
26079,"Kalkaska County, Michigan",67,61,0,51,10,6,16344,14299,327,11623,2349,2045,17208,15099,338,12330,2431,2109
26081,"Kent County, Michigan",60274,51886,141,44624,7121,8388,464950,438218,2463,411201,24554,26732,625313,582970,2911,538632,41427,42343
26083,"Keweenaw County, Michigan",29,29,0,29,0,0,2074,1687,23,1314,350,387,2119,1727,23,1354,350,392
26085,"Lake County, Michigan",766,559,0,443,116,207,9696,7738,100,6195,1443,1958,11297,9019,111,7216,1692,2278
26087,"Lapeer County, Michigan",229,225,0,137,88,4,80261,74279,1180,65181,7918,5982,86346,79562,1186,69907,8469,6784
26089,"Leelanau County, Michigan",66,60,0,60,0,6,19157,17784,150,16512,1122,1373,21161,19622,155,18096,1371,1539
26091,"Lenawee County, Michigan",1345,1335,0,1150,185,10,82376,75675,707,68078,6890,6701,93316,85465,754,76282,8429,7851
26093,"Livingston County, Michigan",850,816,0,740,76,34,175972,168221,858,154800,12563,7751,185763,177716,867,163666,13183,8047
26095,"Luce County, Michigan",19,4,0,4,0,15,4562,3647,175,2954,518,915,5348,4318,182,3519,617,1030
26097,"Mackinac County, Michigan",167,142,0,84,58,25,7871,6728,132,5657,939,1143,10556,9067,150,7584,1333,1489
26099,"Macomb County, Michigan",92974,83467,271,72503,10693,9507,687484,635018,2029,599195,33794,52466,855273,789029,2464,738504,48061,66244
26101,"Manistee County, Michigan",104,90,0,79,11,14,21140,18268,235,16370,1663,2872,22986,19994,235,17820,1939,2992
26103,"Marquette County, Michigan",220,200,0,177,23,20,58732,53678,269,47871,5538,5054,62610,57200,288,50922,5990,5410
26105,"Mason County, Michigan",110,108,0,69,39,2,26129,23378,303,20006,3069,2751,28317,25449,317,21704,3428,2868
26107,"Mecosta County, Michigan",825,747,3,479,265,78,37025,33094,740,27465,4889,3931,40155,35829,757,29760,5312,4326
26109,"Menominee County, Michigan",26,26,0,21,5,0,21512,18622,249,16383,1990,2890,23006,19969,250,17523,2196,3037
26111,"Midland County, Michigan",1061,914,0,831,83,147,75496,68732,916,61354,6462,6764,82133,74860,919,66903,7038,7273
26113,"Missaukee County, Michigan",61,61,0,54,7,0,13962,12300,175,10331,1794,1662,14797,13042,177,10915,1950,1755
26115,"Monroe County, Michigan",3298,2804,14,2409,381,494,136018,124664,1289,112835,10540,11354,148313,135918,1335,122684,11899,12395
26117,"Montcalm County, Michigan",188,188,0,121,67,0,56649,49211,557,40600,8054,7438,60270,52490,575,43310,8605,7780
26119,"Montmorency County, Michigan",0,0,0,0,0,0,8800,7508,143,6339,1026,1292,9123,7803,144,6588,1071,1320
26121,"Muskegon County, Michigan",20792,16650,74,13276,3300,4142,128726,116602,1048,104226,11328,12124,166017,148198,1230,129931,17037,17819
26123,"Newaygo County, Michigan",492,408,0,339,69,84,42879,37094,653,29818,6623,5785,47113,40867,681,32859,7327,6246
26125,"Oakland County, Michigan",167832,154278,718,137452,16108,13554,896369,856560,3318,812030,41212,39809,1229892,1171914,4172,1101734,66008,57978
26127,"Oceana County, Michigan",65,60,0,60,0,5,21343,18806,343,15310,3153,2537,25616,22260,367,17703,4190,3356
26129,"Ogemaw County, Michigan",31,31,0,4,27,0,19663,16698,284,14015,2399,2965,20663,17610,291,14760,2559,3053
26131,"Ontonagon County, Michigan",5,5,0,5,0,0,5711,4644,82,3723,839,1067,5982,4878,82,3910,886,1104
26133,"Osceola County, Michigan",75,70,0,20,50,5,21769,18107,291,14134,3682,3662,22759,18985,295,14786,3904,3774
26135,"Oscoda County, Michigan",41,41,0,41,0,0,7893,6036,253,4911,872,1857,8231,6319,253,5151,915,1912
26137,"Otsego County, Michigan",43,43,0,43,0,0,22618,20728,183,18088,2457,1890,23822,21866,189,18967,2710,1956
26139,"Ottawa County, Michigan",3484,3209,0,3029,180,275,228759,216892,1069,202973,12850,11867,270778,256193,1082,236895,18216,14585
26141,"Presque Isle County, Michigan",41,39,6,29,4,2,12150,10101,263,8481,1357,2049,12628,10540,274,8841,1425,2088
26143,"Roscommon County, Michigan",38,38,0,15,23,0,22604,19424,169,17208,2047,3180,23671,20458,178,18067,2213,3213
26145,"Saginaw County, Michigan",34135,26521,46,22025,4450,7614,131272,117044,968,107254,8822,14228,187394,162603,1032,146660,14911,24791
26147,"St. Clair County, Michigan",3111,2526,84,2233,209,585,144641,133124,1448,121058,10618,11517,158042,145161,1553,132108,11500,12881
26149,"St. Joseph County, Michigan",1435,1117,0,849,268,318,52287,46073,531,39616,5926,6214,60163,52912,549,45032,7331,7251
26151,"Sanilac County, Michigan",176,140,0,128,12,36,38642,32891,532,27625,4734,5751,40924,34983,543,29245,5195,5941
26153,"Schoolcraft County, Michigan",25,25,0,25,0,0,6876,5541,184,4782,575,1335,7969,6379,193,5487,699,1590
26155,"Shiawassee County, Michigan",208,201,0,201,0,7,64118,57893,496,51422,5975,6225,67900,61286,508,54504,6274,6614
26157,"Tuscola County, Michigan",350,274,0,249,25,76,49274,44029,701,37117,6211,5245,52300,46755,713,39398,6644,5545
26159,"Van Buren County, Michigan",2060,1576,26,1157,393,484,60639,54341,547,46852,6942,6298,73835,65630,638,56172,8820,8205
26161,"Washtenaw County, Michigan",39408,35967,142,30938,4887,3441,243254,233734,792,219207,13735,9520,341607,327307,1044,303876,22387,14300
26163,"Wayne County, Michigan",678659,570717,2875,410070,157772,107942,866873,799512,3548,722520,73444,67361,1741646,1549798,7130,1281065,261603,191848
26165,"Wexford County, Michigan",203,142,0,115,27,61,30936,27150,349,22220,4581,3786,32599,28661,365,23534,4762,3938
27001,"Aitkin County, Minnesota",55,46,0,28,18,9,14699,12634,194,10567,1873,2065,15576,13404,194,11213,1997,2172
27003,"Anoka County, Minnesota",18732,18250,21,16895,1334,482,282978,268836,2464,254701,11671,14142,341863,325682,2618,307246,15818,16181
27005,"Becker County, Minnesota",160,126,0,119,7,34,28629,25429,390,22817,2222,3200,33083,29355,402,26026,2927,3728
27007,"Beltrami County, Minnesota",373,356,0,322,34,17,31285,28922,130,26364,2428,2363,43603,39027,151,34572,4304,4576
27009,"Benton County, Minnesota",1031,984,0,693,291,47,35230,32621,216,29646,2759,2609,38457,35715,220,32116,3379,2742
27011,"Big Stone County, Minnesota",0,0,0,0,0,0,4801,4012,26,3704,282,789,4889,4081,26,3739,316,808
27013,"Blue Earth County, Minnesota",2016,1930,0,1613,317,86,55298,52084,233,48354,3497,3214,61964,58497,238,54237,4022,3467
27015,"Brown County, Minnesota",54,32,0,32,0,22,22583,20406,177,18617,1612,2177,24070,21817,179,19943,1695,2253
27017,"Carlton County, Minnesota",288,282,0,268,14,6,29997,26745,361,23081,3303,3252,33420,29740,368,25646,3726,3680
27019,"Carver County, Minnesota",1458,1458,0,1389,69,0,87864,84971,418,81008,3545,2893,97912,94579,495,89727,4357,3333
27021,"Cass County, Minnesota",83,71,0,71,0,12,23691,21064,316,18467,2281,2627,28450,24974,322,21763,2889,3476
27023,"Chippewa County, Minnesota",62,31,0,28,3,31,10465,9417,245,8399,773,1048,11774,10501,268,9139,1094,1273
27025,"Chisago County, Minnesota",218,218,0,177,41,0,49883,47249,522,43886,2841,2634,52436,49586,531,45980,3075,2850
27027,"Clay County, Minnesota",1326,1249,0,1077,172,77,51616,46930,207,41949,4774,4686,58154,52885,217,46841,5827,5269
27029,"Clearwater County, Minnesota",30,20,0,20,0,10,7408,6271,69,5562,640,1137,8707,7269,69,6425,775,1438
27031,"Cook County, Minnesota",25,25,0,25,0,0,4469,4045,124,3388,533,424,5195,4674,142,3914,618,521
27033,"Cottonwood County, Minnesota",67,67,0,67,0,0,9698,8632,74,7607,951,1066,11148,9958,78,8913,967,1190
27035,"Crow Wing County, Minnesota",365,361,0,340,21,4,59666,54697,496,50432,3769,4969,62608,57502,505,52965,4032,5106
27037,"Dakota County, Minnesota",23322,22740,8,20428,2304,582,328152,315937,1329,300740,13868,12215,411998,397190,1524,372591,23075,14808
27039,"Dodge County, Minnesota",47,47,0,47,0,0,18830,17594,85,16479,1030,1236,20333,19039,113,17842,1084,1294
27041,"Douglas County, Minnesota",215,160,0,121,39,55,34995,32157,610,28603,2944,2838,36334,33270,659,29380,3231,3064
27043,"Faribault County, Minnesota",11,11,0,3,8,0,12527,10945,123,9771,1051,1582,13660,11950,123,10635,1192,1710
27045,"Fillmore County, Minnesota",99,99,0,99,0,0,19765,16986,275,15296,1415,2779,20429,17619,278,15747,1594,2810
27047,"Freeborn County, Minnesota",386,377,0,329,48,9,25938,23212,239,20919,2054,2726,30020,27032,242,24150,2640,2988
27049,"Goodhue County, Minnesota",363,363,0,274,89,0,41905,38803,506,35505,2792,3102,45176,42018,576,38239,3203,3158
27051,"Grant County, Minnesota",7,7,0,5,2,0,5579,5055,156,4277,622,524,5835,5303,156,4454,693,532
27053,"Hennepin County, Minnesota",151299,135896,666,109787,25443,15403,834577,797419,4660,754862,37897,37158,1199720,1138133,5741,1048435,83957,61587
27055,"Houston County, Minnesota",117,108,0,108,0,9,17780,16247,196,14989,1062,1533,18441,16876,196,15546,1134,1565
27057,"Hubbard County, Minnesota",161,161,0,141,20,0,19206,17562,322,15417,1823,1644,20571,18839,327,16463,2049,1732
27059,"Isanti County, Minnesota",174,126,6,117,3,48,35888,33250,462,29968,2820,2638,37994,35292,474,31890,2928,2702
27061,"Itasca County, Minnesota",91,91,0,91,0,0,40670,36288,178,32831,3279,4382,44023,39280,181,35408,3691,4743
27063,"Jackson County, Minnesota",0,0,0,0,0,0,9291,8322,86,7517,719,969,9978,8951,86,8128,737,1027
27065,"Kanabec County, Minnesota",64,43,0,41,2,21,14967,13224,172,11175,1877,1743,15718,13912,175,11709,2028,1806
27067,"Kandiyohi County, Minnesota",1799,1345,0,1047,298,454,33858,31073,295,28518,2260,2785,41489,37743,319,34160,3264,3746
27069,"Kittson County, Minnesota",16,15,0,12,3,1,4045,3499,85,2454,960,546,4183,3636,87,2527,1022,547
27071,"Koochiching County, Minnesota",73,73,0,73,0,0,11690,10225,79,9261,885,1465,12459,10828,79,9671,1078,1631
27073,"Lac qui Parle County, Minnesota",79,79,0,79,0,0,6395,5571,40,5045,486,824,6697,5850,40,5280,530,847
27075,"Lake County, Minnesota",55,55,0,55,0,0,9941,8951,153,7897,901,990,10312,9258,153,8204,901,1054
27077,"Lake of the Woods County, Minnesota",0,0,0,0,0,0,3536,2937,23,1542,1372,599,3783,3184,23,1785,1376,599
27079,"Le Sueur County, Minnesota",174,153,0,144,9,21,25201,23541,331,21414,1796,1660,27415,25438,331,23013,2094,1977
27081,"Lincoln County, Minnesota",11,11,0,11,0,0,5363,4614,52,4124,438,749,5540,4742,52,4234,456,798
27083,"Lyon County, Minnesota",828,750,0,723,27,78,20875,19401,206,17978,1217,1474,24512,22736,222,20925,1589,1776
27085,"McLeod County, Minnesota",53,51,0,51,0,2,32508,29930,285,27696,1949,2578,35437,32670,296,30082,2292,2767
27087,"Mahnomen County, Minnesota",17,12,0,2,10,5,2488,2098,21,1841,236,390,5442,4440,27,3656,757,1002
27089,"Marshall County, Minnesota",21,21,0,21,0,0,8721,7676,201,6636,839,1045,9299,8199,201,7050,948,1100
27091,"Martin County, Minnesota",50,50,0,50,0,0,18486,16293,271,14880,1142,2193,19741,17529,271,16062,1196,2212
27093,"Meeker County, Minnesota",158,100,0,74,26,58,21459,19427,213,17155,2059,2032,22743,20574,213,17964,2397,2169
27095,"Mille Lacs County, Minnesota",80,77,0,42,35,3,22465,20150,211,17709,2230,2315,25110,22317,216,19536,2565,2793
27097,"Morrison County, Minnesota",178,22,0,22,0,156,31051,27408,344,24357,2707,3643,32327,28412,344,25221,2847,3915
27099,"Mower County, Minnesota",1284,1115,0,852,263,169,31330,28484,315,25956,2213,2846,38719,35393,340,31876,3177,3326
27101,"Murray County, Minnesota",48,33,0,33,0,15,7739,6890,95,6188,607,849,8234,7358,95,6623,640,876
27103,"Nicollet County, Minnesota",787,631,0,471,160,156,27584,25639,235,24175,1229,1945,30536,28421,284,26601,1536,2115
27105,"Nobles County, Minnesota",929,903,0,880,23,26,12900,11488,174,10294,1020,1412,21418,19047,174,16572,2301,2371
27107,"Norman County, Minnesota",54,54,0,54,0,0,5770,4748,57,3909,782,1022,6445,5357,57,4461,839,1088
27109,"Olmsted County, Minnesota",8261,7916,11,7534,371,345,120996,115167,669,108683,5815,5829,148981,141683,775,133689,7219,7298
27111,"Otter Tail County, Minnesota",751,646,46,413,187,105,52776,47008,1023,40411,5574,5768,56639,50530,1116,43155,6259,6109
27113,"Pennington County, Minnesota",205,196,0,113,83,9,12736,11393,35,10351,1007,1343,13938,12491,35,11252,1204,1447
27115,"Pine County, Minnesota",165,157,0,157,0,8,25108,21736,357,18033,3346,3372,27328,23698,370,19751,3577,3630
27117,"Pipestone County, Minnesota",116,20,0,20,0,96,8099,7109,69,6453,587,990,9050,7863,69,6910,884,1187
27119,"Polk County, Minnesota",494,368,0,364,4,126,26681,23797,170,21630,1997,2884,30206,26918,175,24565,2178,3288
27121,"Pope County, Minnesota",50,50,0,44,6,0,10333,9372,125,8296,951,961,10717,9677,125,8582,970,1040
27123,"Ramsey County, Minnesota",60173,53499,147,46803,6549,6674,327572,307750,1848,290785,15117,19822,522417,489863,3098,454292,32473,32554
27125,"Red Lake County, Minnesota",17,17,0,17,0,0,3692,3202,39,2876,287,490,3985,3481,39,3104,338,504
27127,"Redwood County, Minnesota",110,87,0,37,50,23,13157,11758,228,9880,1650,1399,15049,13377,228,11228,1921,1672
27129,"Renville County, Minnesota",54,54,0,54,0,0,12825,11410,176,9276,1958,1415,14446,12833,176,10375,2282,1613
27131,"Rice County, Minnesota",2336,2216,0,2185,31,120,48674,45097,476,42351,2270,3577,57030,52844,519,49228,3097,4186
27133,"Rock County, Minnesota",91,80,0,55,25,11,8626,7868,75,7285,508,758,9171,8392,81,7637,674,779
27135,"Roseau County, Minnesota",128,122,0,41,81,6,14159,12815,136,8702,3977,1344,15320,13727,145,9256,4326,1593
27137,"St. Louis County, Minnesota",2457,2253,121,1637,495,204,175902,158877,1888,142528,14461,17025,191062,172645,2059,154057,16529,18417
27139,"Scott County, Minnesota",4808,4648,0,4096,552,160,115177,111416,582,105529,5305,3761,139877,134824,599,127187,7038,5053
27141,"Sherburne County, Minnesota",1655,1440,0,1212,228,215,83254,80487,693,74795,4999,2767,89877,86751,693,80420,5638,3126
27143,"Sibley County, Minnesota",78,78,0,73,5,0,13068,11750,249,10158,1343,1318,14664,13161,250,11359,1552,1503
27145,"Stearns County, Minnesota",7455,6756,30,5886,840,699,130085,121538,959,109619,10960,8547,147165,137335,1036,123093,13206,9830
27147,"Steele County, Minnesota",1146,1146,0,1077,69,0,31522,28973,237,27046,1690,2549,36058,33284,237,31081,1966,2774
27149,"Stevens County, Minnesota",80,80,0,80,0,0,8383,7658,52,6780,826,725,9359,8553,81,7400,1072,806
27151,"Swift County, Minnesota",205,193,0,92,101,12,8597,7496,124,6592,780,1101,9296,8111,168,6998,945,1185
27153,"Todd County, Minnesota",95,90,0,78,12,5,22077,18243,410,15860,1973,3834,24067,19932,410,17471,2051,4135
27155,"Traverse County, Minnesota",17,10,0,8,2,7,2953,2537,36,2204,297,416,3262,2810,36,2412,362,452
27157,"Wabasha County, Minnesota",87,77,0,74,3,10,20152,18310,186,16675,1449,1842,21223,19171,198,17449,1524,2052
27159,"Wadena County, Minnesota",105,100,0,97,3,5,12566,10973,173,9634,1166,1593,13197,11552,173,10142,1237,1645
27161,"Waseca County, Minnesota",247,247,0,244,3,0,16172,14992,84,13777,1131,1180,17697,16469,90,15176,1203,1228
27163,"Washington County, Minnesota",9382,8841,0,8596,245,541,207935,200599,847,192724,7028,7336,247179,238987,870,229743,8374,8192
27165,"Watonwan County, Minnesota",65,64,0,64,0,1,7945,6856,103,5985,768,1089,10783,9033,103,7594,1336,1750
27167,"Wilkin County, Minnesota",27,27,0,27,0,0,5873,5244,46,4823,375,629,6230,5467,57,5008,402,763
27169,"Winona County, Minnesota",630,500,0,473,27,130,43183,39448,242,36641,2565,3735,46888,42913,242,39915,2756,3975
27171,"Wright County, Minnesota",1763,1755,0,1716,39,8,120973,115472,874,106785,7813,5501,130006,124238,970,115026,8242,5768
27173,"Yellow Medicine County, Minnesota",50,50,0,50,0,0,8682,7785,111,6937,737,897,9643,8667,119,7768,780,976
28001,"Adams County, Mississippi",16377,12698,75,11482,1141,3679,11065,9562,68,8545,949,1503,29127,23743,143,21469,2131,5384
28003,"Alcorn County, Mississippi",4183,3325,0,2344,981,858,30665,25782,271,20711,4800,4883,36731,30913,271,24227,6415,5818
28005,"Amite County, Mississippi",5239,3948,0,2577,1371,1291,7145,5724,102,4542,1080,1421,12470,9750,102,7171,2477,2720
28007,"Attala County, Mississippi",7921,6066,51,4139,1876,1855,9874,8629,49,7233,1347,1245,18370,15259,111,11748,3400,3111
28009,"Benton County, Mississippi",3018,2738,0,2044,694,280,4951,4100,12,2920,1168,851,8234,7055,15,5157,1883,1179
28011,"Bolivar County, Mississippi",20490,14745,166,10102,4477,5745,9984,8699,33,7630,1036,1285,31570,24412,199,18623,5590,7158
28013,"Calhoun County, Mississippi",3910,2512,40,1648,824,1398,9343,7803,121,6051,1631,1540,14378,11126,161,8193,2772,3252
28015,"Carroll County, Mississippi",3317,2473,0,2002,471,844,6526,5437,57,4746,634,1089,10062,8070,57,6901,1112,1992
28017,"Chickasaw County, Mississippi",7353,5656,0,4111,1545,1697,8596,6967,118,5405,1444,1629,17003,13372,118,10240,3014,3631
28019,"Choctaw County, Mississippi",2536,1934,84,1021,829,602,5560,4703,75,3694,934,857,8210,6728,159,4740,1829,1482
28021,"Claiborne County, Mississippi",7460,5453,72,4615,766,2007,956,737,33,645,59,219,8478,6227,105,5262,860,2251
28023,"Clarke County, Mississippi",5617,4179,13,2833,1333,1438,10176,8561,154,6430,1977,1615,16035,12982,167,9463,3352,3053
28025,"Clay County, Mississippi",11667,8807,0,6774,2033,2860,7721,6977,95,5754,1128,744,19745,16121,95,12865,3161,3624
28027,"Coahoma County, Mississippi",18331,13070,370,9562,3138,5261,4941,4132,103,3432,597,809,23551,17421,473,13206,3742,6130
28029,"Copiah County, Mississippi",14272,8768,7,4657,4104,5504,12380,9923,168,7359,2396,2457,27683,19413,175,12632,6606,8270
28031,"Covington County, Mississippi",6870,5554,165,2496,2893,1316,11444,9886,171,7724,1991,1558,18931,16057,358,10732,4967,2874
28033,"DeSoto County, Mississippi",43755,39209,259,32718,6232,4546,114992,107887,443,98976,8468,7105,172515,159937,702,142981,16254,12578
28035,"Forrest County, Mississippi",26292,23394,169,17503,5722,2898,41229,37612,183,32807,4622,3617,71966,64801,395,53599,10807,7165
28037,"Franklin County, Mississippi",2752,2300,29,2018,253,452,4856,4154,77,3582,495,702,7674,6517,106,5640,771,1157
28039,"George County, Mississippi",1586,1260,0,704,556,326,20343,17506,175,14770,2561,2837,23051,19772,175,16043,3554,3279
28041,"Greene County, Mississippi",1518,1355,32,1121,202,163,8742,7399,39,6194,1166,1343,10482,8949,71,7483,1395,1533
28043,"Grenada County, Mississippi",9070,6629,0,4951,1678,2441,11613,9925,9,8030,1886,1688,21023,16804,9,13210,3585,4219
28045,"Hancock County, Mississippi",3889,3481,0,2600,881,408,39051,34817,65,30262,4490,4234,45899,40974,65,35273,5636,4925
28047,"Harrison County, Mississippi",47359,38462,83,33227,5152,8897,126617,114436,405,104661,9370,12181,195638,171729,507,155187,16035,23909
28049,"Hinds County, Mississippi",168944,145794,619,118924,26251,23150,59225,54230,125,49900,4205,4995,234691,206022,744,173791,31487,28669
28051,"Holmes County, Mississippi",14839,9810,44,4491,5275,5029,2556,2015,22,1566,427,541,17593,11958,66,6190,5702,5635
28053,"Humphreys County, Mississippi",6506,4731,13,3670,1048,1775,1817,1596,11,1207,378,221,8591,6595,24,5097,1474,1996
28055,"Issaquena County, Mississippi",652,354,0,301,53,298,384,335,0,298,37,49,1041,694,0,604,90,347
28057,"Itawamba County, Mississippi",1398,1236,0,925,311,162,20579,17634,202,15122,2310,2945,22371,19208,202,16385,2621,3163
28059,"Jackson County, Mississippi",30910,26618,444,20446,5728,4292,95828,87660,539,78768,8353,8168,140194,126192,983,109759,15450,14002
28061,"Jasper County, Mississippi",8920,6893,138,3728,3027,2027,7417,6091,129,4492,1470,1326,16477,13115,267,8299,4549,3362
28063,"Jefferson County, Mississippi",6122,4576,20,3759,797,1546,864,769,0,769,0,95,7018,5377,20,4560,797,1641
28065,"Jefferson Davis County, Mississippi",7120,4732,32,2785,1915,2388,4323,3322,65,2221,1036,1001,11499,8098,97,5041,2960,3401
28067,"Jones County, Mississippi",19063,14065,444,8159,5462,4998,43327,37346,737,25965,10644,5981,66505,54852,1181,35620,18051,11653
28069,"Kemper County, Mississippi",5490,3334,37,2107,1190,2156,3078,2622,52,1707,863,456,9095,6400,89,4043,2268,2695
28071,"Lafayette County, Mississippi",11930,9937,17,7066,2854,1993,32672,31127,30,27753,3344,1545,47588,43834,47,36984,6803,3754
28073,"Lamar County, Mississippi",11884,10835,159,9213,1463,1049,45033,42405,201,37762,4442,2628,60151,56470,395,49993,6082,3681
28075,"Lauderdale County, Mississippi",31669,25820,285,17180,8355,5849,40143,34717,132,29540,5045,5426,74932,63464,417,48756,14291,11468
28077,"Lawrence County, Mississippi",4205,2786,101,1457,1228,1419,8283,6148,1,4456,1691,2135,12659,9105,127,6017,2961,3554
28079,"Leake County, Mississippi",9248,7340,23,4571,2746,1908,10642,8480,63,6460,1957,2162,22216,17508,86,11875,5547,4708
28081,"Lee County, Mississippi",24180,20232,76,16527,3629,3948,55697,49921,315,43323,6283,5776,83842,73819,402,62904,10513,10023
28083,"Leflore County, Mississippi",21128,11994,40,7358,4596,9134,6380,5292,16,4417,859,1088,28658,17926,56,12184,5686,10732
28085,"Lincoln County, Mississippi",10273,7710,0,5410,2300,2563,22916,18926,92,14344,4490,3990,33864,27074,92,20136,6846,6790
28087,"Lowndes County, Mississippi",25150,20060,37,13705,6318,5090,30203,27748,76,23616,4056,2455,57844,50047,113,39357,10577,7797
28089,"Madison County, Mississippi",38046,32890,19,25464,7407,5156,56161,53940,756,50098,3086,2221,100380,92274,827,80378,11069,8106
28091,"Marion County, Mississippi",7898,5814,133,3272,2409,2084,16142,13086,54,10176,2856,3056,24734,19565,187,13905,5473,5169
28093,"Marshall County, Mississippi",15680,11197,517,5595,5085,4483,16669,13357,309,10353,2695,3312,33991,25839,826,17150,7863,8152
28095,"Monroe County, Mississippi",10688,7204,97,5023,2084,3484,23809,19747,256,16591,2900,4062,35519,27581,353,22047,5181,7938
28097,"Montgomery County, Mississippi",4306,3046,47,2184,815,1260,5314,4322,45,3747,530,992,10189,7934,92,6330,1512,2255
28099,"Neshoba County, Mississippi",6019,4514,0,3412,1102,1505,17054,14910,137,11955,2818,2144,29025,24363,173,18330,5860,4662
28101,"Newton County, Mississippi",6106,4533,0,2997,1536,1573,12766,11121,134,8535,2452,1645,20698,17185,134,12531,4520,3513
28103,"Noxubee County, Mississippi",7766,5457,24,3680,1753,2309,2770,2339,11,2006,322,431,10743,8003,35,5729,2239,2740
28105,"Oktibbeha County, Mississippi",16823,13611,199,10650,2762,3212,24535,23184,186,20588,2410,1351,44130,39492,385,33471,5636,4638
28107,"Panola County, Mississippi",17173,12604,201,8353,4050,4569,16054,13196,266,9512,3418,2858,34003,26477,467,18024,7986,7526
28109,"Pearl River County, Mississippi",6461,4772,164,3380,1228,1689,44180,40076,127,33844,6105,4104,53456,47452,291,39275,7886,6004
28111,"Perry County, Mississippi",2336,1929,9,1443,477,407,9240,7989,206,6246,1537,1251,11920,10241,221,7971,2049,1679
28113,"Pike County, Mississippi",20789,14544,100,8064,6380,6245,16894,13993,130,11137,2726,2901,38734,29489,230,19915,9344,9245
28115,"Pontotoc County, Mississippi",4677,3451,0,2458,993,1226,23776,20290,92,14911,5287,3486,30811,25795,92,18751,6952,5016
28117,"Prentiss County, Mississippi",3042,2442,0,2290,152,600,20426,17071,142,14660,2269,3355,24305,20311,142,17643,2526,3994
28119,"Quitman County, Mississippi",5276,3818,44,2705,1069,1458,1969,1539,8,1058,473,430,7376,5452,52,3855,1545,1924
28121,"Rankin County, Mississippi",27325,24170,110,21014,3046,3155,109278,101910,382,92934,8594,7368,144123,133263,501,120753,12009,10860
28123,"Scott County, Mississippi",10849,7609,21,4024,3564,3240,13998,11393,34,8605,2754,2605,28146,21450,55,13925,7470,6696
28125,"Sharkey County, Mississippi",3307,2318,18,2054,246,989,1155,979,11,935,33,176,4495,3330,29,3013,288,1165
28127,"Simpson County, Mississippi",9700,6667,7,4211,2449,3033,16401,13066,240,10381,2445,3335,26558,20026,247,14771,5008,6532
28129,"Smith County, Mississippi",3764,3073,0,1572,1501,691,11914,9654,181,5719,3754,2260,16003,13022,181,7563,5278,2981
28131,"Stone County, Mississippi",3137,2242,0,1954,288,895,13499,11191,135,9672,1384,2308,17288,14069,135,12070,1864,3219
28133,"Sunflower County, Mississippi",17215,13820,200,9667,3953,3395,5288,4565,81,3961,523,723,22969,18800,281,13924,4595,4169
28135,"Tallahatchie County, Mississippi",5678,3932,12,2797,1123,1746,4876,3831,17,2868,946,1045,10653,7846,29,5712,2105,2807
28137,"Tate County, Mississippi",7561,5795,5,4369,1421,1766,17552,15811,234,13677,1900,1741,26543,22902,239,19008,3655,3641
28139,"Tippah County, Mississippi",3591,3268,0,2159,1109,323,16870,13726,103,10936,2687,3144,21683,18054,103,14059,3892,3629
28141,"Tishomingo County, Mississippi",395,349,0,348,1,46,18029,15115,267,11632,3216,2914,19219,16196,267,12636,3293,3023
28143,"Tunica County, Mississippi",8006,6717,48,5283,1386,1289,1942,1697,13,1393,291,245,10156,8616,61,6864,1691,1540
28145,"Union County, Mississippi",4090,2844,0,2072,772,1246,22020,18765,169,15258,3338,3255,27929,23255,238,18721,4296,4674
28147,"Walthall County, Mississippi",6663,5186,394,3162,1630,1477,7656,5979,40,4332,1607,1677,14535,11376,434,7700,3242,3159
28149,"Warren County, Mississippi",23541,19282,111,16716,2455,4259,22396,20034,212,18346,1476,2362,46933,40165,323,35767,4075,6768
28151,"Washington County, Mississippi",34099,27335,56,21276,6003,6764,12121,10556,16,9313,1227,1565,47476,38957,72,31562,7323,8519
28153,"Wayne County, Mississippi",8207,6390,0,4166,2224,1817,11747,9754,31,8557,1166,1993,20289,16225,31,12804,3390,4064
28155,"Webster County, Mississippi",1872,1112,0,827,285,760,7642,6817,7,5384,1426,825,9785,8193,19,6463,1711,1592
28157,"Wilkinson County, Mississippi",5592,4035,0,2823,1212,1557,2365,2045,81,1407,557,320,8027,6146,81,4296,1769,1881
28159,"Winston County, Mississippi",8453,6340,0,4477,1863,2113,9131,7196,109,6044,1043,1935,18002,13854,109,10798,2947,4148
28161,"Yalobusha County, Mississippi",4894,4092,42,2225,1825,802,7150,5224,65,3716,1443,1926,12234,9453,107,6051,3295,2781
28163,"Yazoo County, Mississippi",13758,10292,40,7294,2958,3466,8650,6925,43,5468,1414,1725,23423,18125,83,13637,4405,5298
29001,"Adair County, Missouri",437,437,0,188,249,0,20723,18669,69,16527,2073,2054,22648,20511,69,17843,2599,2137
29003,"Andrew County, Missouri",289,261,0,261,0,28,16317,14616,202,12869,1545,1701,17161,15407,218,13576,1613,1754
29005,"Atchison County, Missouri",14,9,0,9,0,5,5052,4380,25,3861,494,672,5225,4517,25,3998,494,708
29007,"Audrain County, Missouri",1291,995,0,741,254,296,20802,17536,207,15598,1731,3266,23771,19854,207,17283,2364,3917
29009,"Barry County, Missouri",109,64,0,64,0,45,30338,26306,219,19196,6891,4032,35091,30047,327,21764,7956,5044
29011,"Barton County, Missouri",6,6,0,6,0,0,10935,8757,90,6546,2121,2178,11786,9357,90,7091,2176,2429
29013,"Bates County, Missouri",152,122,0,104,18,30,15247,13365,177,11422,1766,1882,16078,14128,194,12121,1813,1950
29015,"Benton County, Missouri",54,54,0,53,1,0,17804,14735,300,12197,2238,3069,18672,15410,361,12739,2310,3262
29017,"Bollinger County, Missouri",19,19,0,19,0,0,11748,9825,166,8397,1262,1923,12134,10178,166,8661,1351,1956
29019,"Boone County, Missouri",14247,12356,0,9815,2541,1891,131084,125803,454,114227,11122,5281,165298,157101,534,140616,15951,8197
29021,"Buchanan County, Missouri",4104,2947,0,2453,494,1157,71894,63331,290,56686,6355,8563,85218,74243,320,66012,7911,10975
29023,"Butler County, Missouri",2149,1678,0,1296,382,471,37302,32359,147,27302,4910,4943,41794,36140,147,30323,5670,5654
29025,"Caldwell County, Missouri",14,14,4,10,0,0,8440,6928,54,6079,795,1512,8844,7260,58,6363,839,1584
29027,"Callaway County, Missouri",1222,728,0,614,114,494,37414,33405,351,27726,5328,4009,40843,36214,351,29863,6000,4629
29029,"Camden County, Missouri",296,245,0,244,1,51,41973,37307,705,31819,4783,4666,44359,39528,705,33816,5007,4831
29031,"Cape Girardeau County, Missouri",5670,4698,70,4152,476,972,64730,59403,413,54413,4577,5327,74568,67984,547,62296,5141,6584
29033,"Carroll County, Missouri",69,60,0,60,0,9,8346,7089,112,5759,1218,1257,8796,7488,112,6100,1276,1308
29035,"Carter County, Missouri",0,0,0,0,0,0,5875,5075,48,4127,900,800,6209,5405,48,4232,1125,804
29037,"Cass County, Missouri",3711,3661,0,3435,226,50,89324,84656,575,76810,7271,4668,100893,95802,581,86778,8443,5091
29039,"Cedar County, Missouri",0,0,0,0,0,0,13020,10635,116,9432,1087,2385,13702,11281,125,9931,1225,2421
29041,"Chariton County, Missouri",164,119,0,99,20,45,7014,5886,99,5177,610,1128,7352,6165,99,5411,655,1187
29043,"Christian County, Missouri",421,421,0,416,5,0,77213,72330,411,63199,8720,4883,82376,77266,411,67670,9185,5110
29045,"Clark County, Missouri",11,11,0,0,11,0,6552,5304,101,4726,477,1248,6736,5466,101,4862,503,1270
29047,"Clay County, Missouri",13053,12300,65,10453,1782,753,191736,182187,766,170610,10811,9549,233355,221812,831,205544,15437,11543
29049,"Clinton County, Missouri",383,348,0,267,81,35,18817,17398,208,15301,1889,1419,20034,18504,224,16216,2064,1530
29051,"Cole County, Missouri",6984,6345,87,4209,2049,639,60018,54298,684,44067,9547,5720,71919,65178,771,52281,12126,6741
29053,"Cooper County, Missouri",556,418,5,292,121,138,14652,13075,65,11022,1988,1577,16031,14291,70,12085,2136,1740
29055,"Crawford County, Missouri",26,26,0,7,19,0,22911,19112,309,16435,2368,3799,23954,19940,309,17197,2434,4014
29057,"Dade County, Missouri",8,8,0,8,0,0,7000,5740,113,4700,927,1260,7427,6150,113,5000,1037,1277
29059,"Dallas County, Missouri",9,9,0,9,0,0,15386,12407,133,9657,2617,2979,16224,13124,133,10348,2643,3100
29061,"Daviess County, Missouri",17,17,0,16,1,0,7849,6047,131,5392,524,1802,8097,6290,131,5616,543,1807
29063,"DeKalb County, Missouri",9,9,0,9,0,0,8817,7520,186,6580,754,1297,9028,7713,186,6770,757,1315
29065,"Dent County, Missouri",63,63,0,63,0,0,14561,12356,92,10422,1842,2205,15358,13056,100,11076,1880,2302
29067,"Douglas County, Missouri",4,4,0,4,0,0,13003,10566,410,7649,2507,2437,13262,10796,410,7870,2516,2466
29069,"Dunklin County, Missouri",2887,2232,0,1497,735,655,24471,20256,55,17539,2662,4215,30202,25007,91,21104,3812,5195
29071,"Franklin County, Missouri",802,644,0,564,80,158,96778,88308,1132,75882,11294,8470,101566,92555,1192,79703,11660,9011
29073,"Gasconade County, Missouri",86,48,0,35,13,38,13957,12221,220,10499,1502,1736,14507,12716,220,10953,1543,1791
29075,"Gentry County, Missouri",7,4,0,4,0,3,6270,5351,28,4923,400,919,6451,5507,28,5072,407,944
29077,"Greene County, Missouri",8160,6997,68,5467,1462,1163,243627,222203,1323,192559,28321,21424,275398,250674,1509,216395,32770,24724
29079,"Grundy County, Missouri",25,25,0,0,25,0,9297,7384,107,6557,720,1913,9779,7821,137,6856,828,1958
29081,"Harrison County, Missouri",17,17,0,16,1,0,8010,6680,61,6049,570,1330,8341,6962,61,6269,632,1379
29083,"Henry County, Missouri",285,226,0,208,18,59,20332,17593,229,14767,2597,2739,21598,18676,234,15658,2784,2922
29085,"Hickory County, Missouri",0,0,0,0,0,0,8834,7094,271,6009,814,1740,9265,7460,276,6341,843,1805
29087,"Holt County, Missouri",2,2,0,2,0,0,4243,3676,55,3118,503,567,4389,3811,55,3252,504,578
29089,"Howard County, Missouri",426,322,0,157,165,104,8572,7581,174,6603,804,991,9390,8280,192,7060,1028,1110
29091,"Howell County, Missouri",107,107,0,107,0,0,37401,32046,405,27266,4375,5355,39580,33941,405,28941,4595,5639
29093,"Iron County, Missouri",115,101,0,61,40,14,9397,7937,82,6357,1498,1460,9915,8388,82,6634,1672,1527
29095,"Jackson County, Missouri",159700,132520,427,109651,22442,27180,422625,392523,1839,363934,26750,30102,677173,609461,2475,546496,60490,67712
29097,"Jasper County, Missouri",2257,1851,0,1347,504,406,98482,88342,393,72759,15190,10140,116131,103297,396,83843,19058,12834
29099,"Jefferson County, Missouri",2099,1886,16,1754,116,213,208872,194174,1120,176566,16488,14698,220508,204897,1136,186277,17484,15611
29101,"Johnson County, Missouri",2056,1956,0,1738,218,100,42645,40175,343,36385,3447,2470,49328,46613,348,42212,4053,2715
29103,"Knox County, Missouri",10,10,0,10,0,0,3758,3166,37,2380,749,592,3891,3291,37,2505,749,600
29105,"Laclede County, Missouri",166,166,0,151,15,0,32949,28349,247,23258,4844,4600,35113,30439,247,25183,5009,4674
29107,"Lafayette County, Missouri",569,412,28,286,98,157,29569,26370,220,23069,3081,3199,31980,28382,250,24557,3575,3598
29109,"Lawrence County, Missouri",207,207,0,162,45,0,33668,29136,359,25174,3603,4532,37534,32511,364,27951,4196,5023
29111,"Lewis County, Missouri",223,190,0,175,15,33,8643,7542,278,6607,657,1101,9283,8112,278,7032,802,1171
29113,"Lincoln County, Missouri",958,886,0,880,6,72,50542,46188,414,40381,5393,4354,54068,49285,414,42981,5890,4783
29115,"Linn County, Missouri",62,42,0,42,0,20,11481,9542,32,8236,1274,1939,12077,10107,32,8742,1333,1970
29117,"Livingston County, Missouri",228,169,0,163,6,59,12891,11314,104,9411,1799,1577,13673,12006,116,10058,1832,1667
29119,"McDonald County, Missouri",384,262,0,98,164,122,17691,14726,217,10150,4359,2965,22561,17797,248,11879,5670,4764
29121,"Macon County, Missouri",331,226,0,121,105,105,14147,11903,115,10026,1762,2244,15036,12660,115,10589,1956,2376
29123,"Madison County, Missouri",56,56,0,56,0,0,11483,9338,58,7954,1326,2145,12042,9819,58,8408,1353,2223
29125,"Maries County, Missouri",10,2,0,2,0,8,8522,6659,71,5484,1104,1863,8870,6969,71,5731,1167,1901
29127,"Marion County, Missouri",1432,1221,0,981,240,211,24508,21878,131,19389,2358,2630,27149,24285,137,21373,2775,2864
29129,"Mercer County, Missouri",5,2,0,2,0,3,3458,2535,16,2288,231,923,3600,2651,16,2396,239,949
29131,"Miller County, Missouri",61,61,0,61,0,0,23396,20163,252,16550,3361,3233,24597,20885,257,17238,3390,3712
29133,"Mississippi County, Missouri",2613,1634,0,1310,324,979,9192,8003,53,7030,920,1189,12163,9937,53,8622,1262,2226
29135,"Moniteau County, Missouri",192,192,0,167,25,0,13303,10865,208,8590,2067,2438,14549,11873,350,9286,2237,2676
29137,"Monroe County, Missouri",283,277,0,246,31,6,7968,6515,44,5554,917,1453,8530,7067,44,5987,1036,1463
29139,"Montgomery County, Missouri",155,102,4,76,22,53,10646,8875,134,7259,1482,1771,11253,9383,138,7644,1601,1870
29141,"Morgan County, Missouri",127,127,0,113,14,0,18655,14498,177,11590,2731,4157,19731,15499,177,12150,3172,4232
29143,"New Madrid County, Missouri",2826,2373,0,1722,651,453,14187,11908,5,10071,1832,2279,17683,14839,28,12221,2590,2844
29145,"Newton County, Missouri",478,475,0,277,198,3,49499,42578,417,36191,5970,6921,57216,48871,450,40598,7823,8345
29147,"Nodaway County, Missouri",322,299,0,236,63,23,18421,16531,309,14032,2190,1890,19509,17528,316,14942,2270,1981
29149,"Oregon County, Missouri",0,0,0,0,0,0,10050,8417,214,5953,2250,1633,10645,8829,249,6229,2351,1816
29151,"Osage County, Missouri",49,28,0,28,0,21,13047,11505,137,8902,2466,1542,13332,11722,137,9101,2484,1610
29153,"Ozark County, Missouri",4,4,0,0,4,0,8808,6855,222,5362,1271,1953,9198,7193,222,5679,1292,2005
29155,"Pemiscot County, Missouri",4671,3034,0,2498,536,1637,11792,9668,34,8624,1010,2124,17142,13336,34,11596,1706,3806
29157,"Perry County, Missouri",16,16,0,16,0,0,18019,16003,158,14265,1580,2016,18801,16685,158,14843,1684,2116
29159,"Pettis County, Missouri",1094,940,0,830,110,154,35338,31256,237,26782,4237,4082,41406,36715,282,31052,5381,4691
29161,"Phelps County, Missouri",999,852,0,551,301,147,37338,34132,409,30213,3510,3206,41836,38035,415,33716,3904,3801
29163,"Pike County, Missouri",494,369,31,249,89,125,14947,12591,182,10589,1820,2356,16181,13580,284,11334,1962,2601
29165,"Platte County, Missouri",6442,6326,13,5670,643,116,78810,75810,211,71864,3735,3000,96095,92755,313,87412,5030,3340
29167,"Polk County, Missouri",67,67,0,65,2,0,28141,24072,281,21236,2555,4069,29828,25667,281,22696,2690,4161
29169,"Pulaski County, Missouri",4419,3967,141,3359,467,452,32039,29355,381,25996,2978,2684,43572,40034,522,35643,3869,3538
29171,"Putnam County, Missouri",18,11,0,11,0,7,4605,3909,12,3077,820,696,4773,4070,12,3234,824,703
29173,"Ralls County, Missouri",134,105,0,105,0,29,9688,8669,147,7726,796,1019,10119,9060,147,8112,801,1059
29175,"Randolph County, Missouri",882,751,0,668,83,131,20601,18029,135,15761,2133,2572,22724,19921,135,17431,2355,2803
29177,"Ray County, Missouri",334,276,0,256,20,58,21222,19067,392,15894,2781,2155,22571,20329,457,16926,2946,2242
29179,"Reynolds County, Missouri",62,45,0,45,0,17,5867,4957,104,4190,663,910,6158,5206,104,4432,670,952
29181,"Ripley County, Missouri",29,29,0,9,20,0,13110,10866,49,8789,2028,2244,13754,11423,51,9261,2111,2331
29183,"St. Charles County, Missouri",15755,15019,13,13027,1979,736,332023,318664,2034,301414,15216,13359,377867,362780,2122,340450,20208,15087
29185,"St. Clair County, Missouri",10,10,0,10,0,0,8723,6818,159,5780,879,1905,9144,7158,159,6108,891,1986
29186,"Ste. Genevieve County, Missouri",405,371,0,368,3,34,16909,15057,247,12552,2258,1852,17621,15733,247,13188,2298,1888
29187,"St. Francois County, Missouri",478,215,0,205,10,263,56733,48477,280,43442,4755,8256,59281,50682,280,45473,4929,8599
29189,"St. Louis County, Missouri",233041,210399,516,178701,31182,22642,656054,618752,2845,588651,27256,37302,980690,916945,3564,848911,64470,63745
29195,"Saline County, Missouri",880,839,15,785,39,41,17689,15176,125,13532,1519,2513,21625,18743,147,16763,1833,2882
29197,"Schuyler County, Missouri",37,37,0,13,24,0,4276,3504,17,2679,808,772,4398,3626,17,2741,868,772
29199,"Scotland County, Missouri",82,56,0,56,0,26,4666,4019,31,3412,576,647,4786,4097,31,3490,576,689
29201,"Scott County, Missouri",4304,3456,0,3136,320,848,32062,28144,150,25036,2958,3918,38276,33264,150,29775,3339,5012
29203,"Shannon County, Missouri",5,0,0,0,0,5,7695,5715,191,4282,1242,1980,8158,6066,202,4576,1288,2092
29205,"Shelby County, Missouri",24,17,0,17,0,7,5668,4931,39,4307,585,737,5816,5071,39,4436,596,745
29207,"Stoddard County, Missouri",417,380,2,369,9,37,27894,24469,39,21323,3107,3425,29150,25596,41,22270,3285,3554
29209,"Stone County, Missouri",5,5,0,5,0,0,29627,26720,462,23031,3227,2907,31104,28102,466,24123,3513,3002
29211,"Sullivan County, Missouri",86,30,0,7,23,56,4826,3871,77,3327,467,955,6222,4980,77,4268,635,1242
29213,"Taney County, Missouri",434,422,0,422,0,12,46976,43470,424,36807,6239,3506,52541,48345,427,40841,7077,4196
29215,"Texas County, Missouri",33,5,0,5,0,28,22636,18551,584,14265,3702,4085,24337,20140,600,15428,4112,4197
29217,"Vernon County, Missouri",107,107,0,104,3,0,18888,16453,244,14345,1864,2435,19923,17471,244,15308,1919,2452
29219,"Warren County, Missouri",740,515,0,315,200,225,30568,27556,501,24453,2602,3012,33210,29580,508,26164,2908,3630
29221,"Washington County, Missouri",97,81,0,70,11,16,23022,19247,347,15530,3370,3775,23849,19962,347,16113,3502,3887
29223,"Wayne County, Missouri",50,50,0,50,0,0,12631,10572,167,8623,1782,2059,13223,11078,167,9120,1791,2145
29225,"Webster County, Missouri",343,313,0,283,30,30,34747,27955,347,23069,4539,6792,36616,29657,347,24448,4862,6959
29227,"Worth County, Missouri",0,0,0,0,0,0,1938,1586,5,1425,156,352,1999,1645,7,1482,156,354
29229,"Wright County, Missouri",98,98,0,98,0,0,17267,13940,209,11213,2518,3327,18109,14747,209,11953,2585,3362
29510,"St. Louis city, Missouri",145344,112728,647,85215,26866,32616,130305,119399,318,109880,9201,10906,304311,257216,970,216803,39443,47095
30001,"Beaverhead County, Montana",4,4,0,4,0,0,8153,7272,32,6458,782,881,8859,7889,37,6861,991,970
30003,"Big Horn County, Montana",14,14,0,14,0,0,3602,3113,24,2793,296,489,13133,9788,146,8082,1560,3345
30005,"Blaine County, Montana",16,16,0,16,0,0,2958,2664,0,2363,301,294,6517,5214,0,4283,931,1303
30007,"Broadwater County, Montana",4,4,0,0,4,0,5408,4653,85,4054,514,755,5711,4936,85,4267,584,775
30009,"Carbon County, Montana",23,14,0,14,0,9,9807,8740,148,7463,1129,1067,10364,9213,185,7867,1161,1151
30011,"Carter County, Montana",0,0,0,0,0,0,1266,1079,18,996,65,187,1293,1104,18,1021,65,189
30013,"Cascade County, Montana",884,874,0,856,18,10,68385,59785,424,54044,5317,8600,79131,68741,424,62035,6282,10390
30015,"Chouteau County, Montana",4,4,0,0,4,0,4361,3861,125,3437,299,500,5719,4723,134,4087,502,996
30017,"Custer County, Montana",53,53,0,53,0,0,10599,9540,207,8743,590,1059,11450,10316,209,9387,720,1134
30019,"Daniels County, Montana",0,0,0,0,0,0,1700,1479,4,1286,189,221,1760,1539,4,1340,195,221
30021,"Dawson County, Montana",32,32,0,32,0,0,8324,7440,41,6619,780,884,8866,7962,41,7134,787,904
30023,"Deer Lodge County, Montana",27,20,0,20,0,7,7460,6476,48,5778,650,984,8089,7067,48,6275,744,1022
30025,"Fallon County, Montana",42,42,0,42,0,0,2677,2523,8,2187,328,154,2854,2678,8,2309,361,176
30027,"Fergus County, Montana",8,8,0,8,0,0,10263,9008,194,8050,764,1255,10825,9485,194,8506,785,1340
30029,"Flathead County, Montana",254,254,0,221,33,0,88550,81497,865,74608,6024,7053,94978,87583,882,80188,6513,7395
30031,"Gallatin County, Montana",286,271,42,210,19,15,89567,86422,402,80045,5975,3145,96810,93476,444,86473,6559,3334
30033,"Garfield County, Montana",0,0,0,0,0,0,1083,928,7,864,57,155,1084,929,7,865,57,155
30035,"Glacier County, Montana",39,35,0,10,25,4,3525,3071,30,2893,148,454,12821,9132,103,7985,1044,3689
30037,"Golden Valley County, Montana",30,30,0,30,0,0,640,545,13,467,65,95,747,652,13,560,79,95
30039,"Granite County, Montana",4,4,0,4,0,0,2974,2586,26,2342,218,388,3142,2750,26,2502,222,392
30041,"Hill County, Montana",33,33,0,33,0,0,11217,9998,98,8936,964,1219,16034,13795,265,12251,1279,2239
30043,"Jefferson County, Montana",6,6,0,6,0,0,10601,9751,22,8735,994,850,11352,10490,22,9377,1091,862
30045,"Judith Basin County, Montana",0,0,0,0,0,0,1874,1647,44,1420,183,227,1961,1719,44,1492,183,242
30047,"Lake County, Montana",63,58,0,50,8,5,18919,17083,340,14498,2245,1836,28948,25227,543,20355,4329,3721
30049,"Lewis and Clark County, Montana",196,146,0,138,8,50,59245,54787,308,49683,4796,4458,64504,59561,344,54036,5181,4943
30051,"Liberty County, Montana",0,0,0,0,0,0,2165,1486,23,1271,192,679,2183,1504,23,1289,192,679
30053,"Lincoln County, Montana",6,6,0,6,0,0,17774,15457,156,13649,1652,2317,19025,16640,156,14707,1777,2385
30055,"McCone County, Montana",0,0,0,0,0,0,1513,1258,27,1122,109,255,1707,1452,27,1270,155,255
30057,"Madison County, Montana",17,0,0,0,0,17,7170,6263,82,5400,781,907,7593,6636,84,5697,855,957
30059,"Meagher County, Montana",0,0,0,0,0,0,1850,1660,4,1387,269,190,1975,1699,4,1416,279,276
30061,"Mineral County, Montana",2,2,0,2,0,0,4000,3397,54,2914,429,603,4124,3518,54,2987,477,606
30063,"Missoula County, Montana",390,365,0,342,23,25,99640,94569,505,85590,8474,5071,110754,105146,505,95446,9195,5608
30065,"Musselshell County, Montana",39,39,0,39,0,0,4395,3831,62,3530,239,564,4725,4155,62,3833,260,570
30067,"Park County, Montana",46,46,0,46,0,0,14814,13393,226,11857,1310,1421,15762,14262,226,12688,1348,1500
30069,"Petroleum County, Montana",0,0,0,0,0,0,446,389,4,332,53,57,453,396,4,339,53,57
30071,"Phillips County, Montana",0,0,0,0,0,0,3455,3076,44,2755,277,379,4068,3539,44,3155,340,529
30073,"Pondera County, Montana",25,25,0,21,4,0,4668,3894,17,3378,499,774,5786,4797,31,4094,672,989
30075,"Powder River County, Montana",0,0,0,0,0,0,1464,1282,75,1091,116,182,1563,1372,75,1181,116,191
30077,"Powell County, Montana",15,0,0,0,0,15,5014,4467,68,3484,915,547,5222,4619,68,3631,920,603
30079,"Prairie County, Montana",0,0,0,0,0,0,1285,1105,35,998,72,180,1302,1122,35,1015,72,180
30081,"Ravalli County, Montana",39,39,0,39,0,0,38261,34972,594,29865,4513,3289,41065,37581,594,32189,4798,3484
30083,"Richland County, Montana",0,0,0,0,0,0,10134,9139,9,8338,792,995,11342,10077,9,9066,1002,1265
30085,"Roosevelt County, Montana",21,21,0,21,0,0,3849,3439,14,3280,145,410,10958,8534,29,7449,1056,2424
30087,"Rosebud County, Montana",7,7,0,7,0,0,5167,4540,732,3394,414,627,9208,7183,1161,5296,726,2025
30089,"Sanders County, Montana",16,12,0,12,0,4,10113,7943,118,7129,696,2170,11182,8830,131,7908,791,2352
30091,"Sheridan County, Montana",5,0,0,0,0,5,3180,2928,25,2658,245,252,3480,3210,36,2910,264,270
30093,"Silver Bow County, Montana",178,178,0,178,0,0,30462,26869,206,23466,3197,3593,33438,29369,206,25751,3412,4069
30095,"Stillwater County, Montana",20,18,0,18,0,2,8586,7779,77,7037,665,807,9207,8306,79,7374,853,901
30097,"Sweet Grass County, Montana",5,5,0,5,0,0,3399,2980,16,2715,249,419,3623,3189,49,2891,249,434
30099,"Teton County, Montana",0,0,0,0,0,0,5525,5051,70,4400,581,474,5854,5355,70,4671,614,499
30101,"Toole County, Montana",0,0,0,0,0,0,3848,3322,67,2808,447,526,4274,3709,67,3155,487,565
30103,"Treasure County, Montana",0,0,0,0,0,0,747,665,47,523,95,82,790,705,47,543,115,85
30105,"Valley County, Montana",5,5,0,5,0,0,6300,5619,82,4806,731,681,7408,6595,87,5666,842,813
30107,"Wheatland County, Montana",0,0,0,0,0,0,1960,1519,7,1141,371,441,2070,1620,7,1242,371,450
30109,"Wibaux County, Montana",0,0,0,0,0,0,1055,843,14,694,135,212,1096,884,14,696,174,212
30111,"Yellowstone County, Montana",1015,980,0,901,79,35,133204,124051,1143,113451,9457,9153,152834,141645,1205,129095,11345,11189
31001,"Adams County, Nebraska",150,150,0,139,11,0,25931,23866,232,21849,1785,2065,29787,27151,249,24858,2044,2636
31003,"Antelope County, Nebraska",12,12,0,12,0,0,6036,5259,61,4730,468,777,6328,5512,61,4968,483,816
31005,"Arthur County, Nebraska",0,0,0,0,0,0,411,370,4,336,30,41,421,379,4,345,30,42
31007,"Banner County, Nebraska",4,4,0,4,0,0,651,612,35,533,44,39,728,689,35,610,44,39
31009,"Blaine County, Nebraska",0,0,0,0,0,0,492,454,0,417,37,38,502,464,0,427,37,38
31011,"Boone County, Nebraska",26,26,0,26,0,0,5075,4544,23,4226,295,531,5250,4719,23,4399,297,531
31013,"Box Butte County, Nebraska",36,36,0,36,0,0,9055,8008,9,7289,710,1047,10996,9788,9,8911,868,1208
31015,"Boyd County, Nebraska",10,10,0,10,0,0,1920,1653,3,1446,204,267,2022,1744,3,1537,204,278
31017,"Brown County, Nebraska",0,0,0,0,0,0,2905,2419,13,2160,246,486,3010,2511,13,2229,269,499
31019,"Buffalo County, Nebraska",560,560,0,320,240,0,40768,37937,237,35161,2539,2831,46490,43316,237,39817,3262,3174
31021,"Burt County, Nebraska",33,25,0,25,0,8,6020,5067,60,4433,574,953,6428,5416,60,4709,647,1012
31023,"Butler County, Nebraska",30,30,0,30,0,0,7552,6592,99,5953,540,960,7925,6948,99,6190,659,977
31025,"Cass County, Nebraska",71,71,0,49,22,0,23738,22466,188,20755,1523,1272,25215,23921,188,21882,1851,1294
31027,"Cedar County, Nebraska",1,1,0,1,0,0,8157,7338,90,6729,519,819,8412,7576,90,6964,522,836
31029,"Chase County, Nebraska",0,0,0,0,0,0,3313,2944,0,2830,114,369,3729,3312,0,3008,304,417
31031,"Cherry County, Nebraska",0,0,0,0,0,0,5016,4437,3,4203,231,579,5668,5004,3,4688,313,664
31033,"Cheyenne County, Nebraska",39,39,0,39,0,0,8907,8057,62,7091,904,850,9903,9049,62,7979,1008,854
31035,"Clay County, Nebraska",26,26,0,26,0,0,5492,5018,60,4449,509,474,6165,5617,65,4900,652,548
31037,"Colfax County, Nebraska",292,268,0,268,0,24,5341,4596,52,4185,359,745,10521,8640,52,7636,952,1881
31039,"Cuming County, Nebraska",8,8,0,8,0,0,7851,6891,137,5960,794,960,8890,7814,137,6730,947,1076
31041,"Custer County, Nebraska",85,74,0,74,0,11,10176,8904,67,7477,1360,1272,10710,9346,75,7793,1478,1364
31043,"Dakota County, Nebraska",863,755,0,665,90,108,10027,9075,47,8350,678,952,20260,18681,172,15906,2603,1579
31045,"Dawes County, Nebraska",72,72,0,72,0,0,6756,5810,89,5211,510,946,7897,6718,89,6085,544,1179
31047,"Dawson County, Nebraska",1385,1342,0,728,614,43,14109,12673,209,11443,1021,1436,23577,21395,209,18801,2385,2182
31049,"Deuel County, Nebraska",1,1,0,1,0,0,1682,1518,18,1262,238,164,1882,1692,18,1412,262,190
31051,"Dixon County, Nebraska",15,11,0,10,1,4,4854,4364,45,3794,525,490,5683,5044,45,4324,675,639
31053,"Dodge County, Nebraska",328,294,0,280,14,34,30199,27665,168,25118,2379,2534,35599,31973,168,28357,3448,3626
31055,"Douglas County, Nebraska",59109,47404,112,40107,7185,11705,377397,355273,1318,336157,17798,22124,537134,487844,2361,451679,33804,49290
31057,"Dundy County, Nebraska",0,0,0,0,0,0,1663,1367,7,1275,85,296,1966,1669,7,1564,98,297
31059,"Fillmore County, Nebraska",3,3,0,3,0,0,5113,4521,44,4048,429,592,5374,4778,44,4238,496,596
31061,"Franklin County, Nebraska",7,7,0,5,2,0,2838,2486,16,2218,252,352,2940,2570,20,2278,272,370
31063,"Frontier County, Nebraska",1,1,0,0,1,0,2407,2083,12,1789,282,324,2497,2173,12,1875,286,324
31065,"Furnas County, Nebraska",15,15,0,12,3,0,4454,3905,19,3518,368,549,4726,4167,33,3746,388,559
31067,"Gage County, Nebraska",127,73,0,56,17,54,19967,17898,154,16522,1222,2069,21033,18872,179,17381,1312,2161
31069,"Garden County, Nebraska",3,0,0,0,0,3,1758,1556,5,1349,202,202,1867,1662,5,1436,221,205
31071,"Garfield County, Nebraska",4,4,0,4,0,0,1847,1567,0,1264,303,280,1913,1633,0,1315,318,280
31073,"Gosper County, Nebraska",0,0,0,0,0,0,1907,1716,8,1585,123,191,1983,1776,8,1639,129,207
31075,"Grant County, Nebraska",6,6,0,6,0,0,615,532,3,501,28,83,641,558,3,527,28,83
31077,"Greeley County, Nebraska",15,15,0,15,0,0,2317,2021,29,1702,290,296,2409,2108,29,1765,314,301
31079,"Hall County, Nebraska",1292,1024,0,955,69,268,40875,36908,221,34126,2561,3967,60299,52971,310,48553,4108,7328
31081,"Hamilton County, Nebraska",61,28,0,3,25,33,8581,7927,125,7104,698,654,9008,8316,125,7395,796,692
31083,"Harlan County, Nebraska",30,30,0,30,0,0,3222,2834,24,2654,156,388,3413,2986,24,2771,191,427
31085,"Hayes County, Nebraska",0,0,0,0,0,0,898,763,5,687,71,135,957,811,5,731,75,146
31087,"Hitchcock County, Nebraska",0,0,0,0,0,0,2798,2382,67,1974,341,416,2823,2390,67,1982,341,433
31089,"Holt County, Nebraska",15,15,0,15,0,0,9460,8310,104,7035,1171,1150,10076,8814,114,7485,1215,1262
31091,"Hooker County, Nebraska",0,0,0,0,0,0,598,506,0,406,100,92,618,515,0,415,100,103
31093,"Howard County, Nebraska",3,0,0,0,0,3,6100,5400,148,4744,508,700,6378,5672,148,5016,508,706
31095,"Jefferson County, Nebraska",0,0,0,0,0,0,6746,5700,89,5033,578,1046,7158,6067,89,5385,593,1091
31097,"Johnson County, Nebraska",2,2,0,2,0,0,3636,3087,54,2821,212,549,4004,3423,54,3101,268,581
31099,"Kearney County, Nebraska",6,6,0,6,0,0,6001,5454,38,4934,482,547,6474,5924,38,5387,499,550
31101,"Keith County, Nebraska",55,55,0,20,35,0,7279,6576,43,6128,405,703,8044,7243,43,6754,446,801
31103,"Keya Paha County, Nebraska",1,1,1,0,0,0,704,627,8,566,53,77,720,643,10,572,61,77
31105,"Kimball County, Nebraska",4,4,0,4,0,0,3203,2834,31,2369,434,369,3632,3261,31,2696,534,371
31107,"Knox County, Nebraska",13,13,0,13,0,0,7115,5964,99,5272,593,1151,8275,6890,101,5903,886,1385
31109,"Lancaster County, Nebraska",11067,10126,5,8527,1594,941,241553,229419,977,215518,12924,12134,292907,278117,1087,257952,19078,14790
31111,"Lincoln County, Nebraska",370,363,0,269,94,7,30798,28103,279,25023,2801,2695,34765,31756,301,28012,3443,3009
31113,"Logan County, Nebraska",6,6,0,6,0,0,863,755,14,640,101,108,919,809,14,679,116,110
31115,"Loup County, Nebraska",0,0,0,0,0,0,535,446,5,369,72,89,537,448,5,371,72,89
31117,"McPherson County, Nebraska",0,0,0,0,0,0,415,339,0,298,41,76,429,353,0,308,45,76
31119,"Madison County, Nebraska",470,360,0,334,26,110,27363,24757,405,22172,2180,2606,33991,30716,528,27035,3153,3275
31121,"Merrick County, Nebraska",23,0,0,0,0,23,7106,6388,73,5465,850,718,7617,6801,73,5854,874,816
31123,"Morrill County, Nebraska",38,38,0,30,8,0,3884,3414,32,2855,527,470,4732,4072,32,3477,563,660
31125,"Nance County, Nebraska",0,0,0,0,0,0,3308,2865,11,2699,155,443,3415,2952,11,2780,161,463
31127,"Nemaha County, Nebraska",53,53,0,38,15,0,6264,5604,127,4816,661,660,6501,5836,127,5023,686,665
31129,"Nuckolls County, Nebraska",10,0,0,0,0,10,4046,3575,40,3179,356,471,4237,3745,78,3311,356,492
31131,"Otoe County, Nebraska",32,16,0,16,0,16,13982,12631,137,11266,1228,1351,15643,13919,140,12287,1492,1724
31133,"Pawnee County, Nebraska",0,0,0,0,0,0,2542,1958,44,1757,157,584,2666,2060,44,1859,157,606
31135,"Perkins County, Nebraska",4,0,0,0,0,4,2737,2562,2,2328,232,175,2867,2685,6,2439,240,182
31137,"Phelps County, Nebraska",10,10,0,10,0,0,8257,7625,36,6881,708,632,8906,8230,36,7395,799,676
31139,"Pierce County, Nebraska",22,22,0,22,0,0,6819,6041,41,5497,503,778,7044,6266,41,5701,524,778
31141,"Platte County, Nebraska",73,73,0,73,0,0,25966,23319,329,21367,1623,2647,32411,29043,329,26696,2018,3368
31143,"Polk County, Nebraska",7,7,0,7,0,0,4780,4363,47,4099,217,417,5152,4694,47,4368,279,458
31145,"Red Willow County, Nebraska",79,79,0,10,69,0,9718,8736,91,7668,977,982,10463,9478,91,8191,1196,985
31147,"Richardson County, Nebraska",16,16,0,16,0,0,7299,6271,12,5859,400,1028,7899,6751,12,6285,454,1148
31149,"Rock County, Nebraska",4,4,0,4,0,0,1290,1116,16,1017,83,174,1323,1145,16,1042,87,178
31151,"Saline County, Nebraska",67,67,0,67,0,0,9214,8285,140,7395,750,929,13314,11667,140,10313,1214,1647
31153,"Sarpy County, Nebraska",6642,6138,0,5776,362,504,142385,137541,366,132039,5136,4844,173994,168097,373,160844,6880,5897
31155,"Saunders County, Nebraska",47,47,0,47,0,0,19822,18165,159,16458,1548,1657,20677,18912,184,17082,1646,1765
31157,"Scotts Bluff County, Nebraska",226,204,0,204,0,22,25866,23282,325,21133,1824,2584,35703,31658,360,28467,2831,4045
31159,"Seward County, Nebraska",61,61,0,58,3,0,14854,13750,202,12393,1155,1104,15619,14469,244,12956,1269,1150
31161,"Sheridan County, Nebraska",24,24,0,24,0,0,4175,3426,95,2922,409,749,5116,4181,95,3582,504,935
31163,"Sherman County, Nebraska",0,0,0,0,0,0,2900,2564,56,2232,276,336,2987,2651,56,2297,298,336
31165,"Sioux County, Nebraska",5,5,0,5,0,0,1130,985,8,843,134,145,1256,1104,8,899,197,152
31167,"Stanton County, Nebraska",77,77,0,75,2,0,5514,4992,65,4469,458,522,5982,5369,65,4841,463,613
31169,"Thayer County, Nebraska",0,0,0,0,0,0,4765,4147,49,3794,304,618,4980,4312,68,3928,316,668
31171,"Thomas County, Nebraska",0,0,0,0,0,0,626,562,0,539,23,64,643,577,0,554,23,66
31173,"Thurston County, Nebraska",14,14,0,11,3,0,2549,2238,76,1873,289,311,7001,5783,256,4313,1214,1218
31175,"Valley County, Nebraska",15,15,0,15,0,0,4013,3467,4,3009,454,546,4187,3581,4,3080,497,606
31177,"Washington County, Nebraska",292,179,0,179,0,113,19072,17915,362,15714,1839,1157,20098,18805,370,16458,1977,1293
31179,"Wayne County, Nebraska",129,129,0,129,0,0,7341,6848,55,6243,550,493,8120,7599,62,6808,729,521
31181,"Webster County, Nebraska",4,4,0,4,0,0,3240,2824,45,2342,437,416,3517,3095,45,2604,446,422
31183,"Wheeler County, Nebraska",0,0,0,0,0,0,837,742,17,644,81,95,846,751,17,647,87,95
31185,"York County, Nebraska",38,29,0,16,13,9,11940,11007,346,9866,795,933,12863,11771,346,10560,865,1092
32001,"Churchill County, Nevada",527,527,0,506,21,0,17461,16271,196,14828,1247,1190,23499,21575,287,19743,1545,1924
32003,"Clark County, Nevada",231307,206959,1285,168131,37543,24348,922132,865152,3681,802103,59368,56980,2089601,1945810,7847,1721043,216920,143791
32005,"Douglas County, Nevada",262,262,2,215,45,0,38477,36403,414,34213,1776,2074,47352,44339,566,41238,2535,3013
32007,"Elko County, Nevada",345,329,0,283,46,16,34722,33270,209,31085,1976,1452,51541,48478,298,43980,4200,3063
32009,"Esmeralda County, Nevada",8,0,0,0,0,8,880,792,9,637,146,88,1097,960,9,683,268,137
32011,"Eureka County, Nevada",0,0,0,0,0,0,1668,1460,16,1351,93,208,1723,1515,16,1406,93,208
32013,"Humboldt County, Nevada",62,62,0,62,0,0,11127,10177,37,8805,1335,950,16871,14401,38,12384,1979,2470
32015,"Lander County, Nevada",0,0,0,0,0,0,3945,3220,38,2797,385,725,5829,5021,46,4045,930,808
32017,"Lincoln County, Nevada",0,0,0,0,0,0,4235,3880,36,3609,235,355,4687,4246,36,3975,235,441
32019,"Lyon County, Nevada",491,491,0,483,8,0,39664,36183,291,33376,2516,3481,52043,47329,351,43016,3962,4714
32021,"Mineral County, Nevada",17,8,0,8,0,9,2564,2253,0,2122,131,311,4392,3807,0,3378,429,585
32023,"Nye County, Nevada",1249,1039,0,1039,0,210,33173,29800,452,25325,4023,3373,42808,38565,753,32728,5084,4243
32027,"Pershing County, Nevada",0,0,0,0,0,0,3513,2857,34,2540,283,656,4696,3780,34,3146,600,916
32029,"Storey County, Nevada",18,6,0,6,0,12,3366,3038,11,2826,201,328,3851,3486,11,3254,221,365
32031,"Washoe County, Nevada",9362,8589,9,7488,1092,773,280496,263422,1180,241694,20548,17074,439520,410553,1797,370863,37893,28967
32033,"White Pine County, Nevada",8,8,0,0,8,0,6602,5836,67,5172,597,766,8365,7391,68,6558,765,974
32510,"Carson City, Nevada",616,513,25,488,0,103,35716,32629,181,29732,2716,3087,52208,48216,232,43563,4421,3992
33001,"Belknap County, New Hampshire",220,220,0,189,31,0,56739,52800,287,49020,3493,3939,59453,55456,287,51469,3700,3997
33003,"Carroll County, New Hampshire",229,197,0,197,0,32,45176,42270,278,38810,3182,2906,46959,43948,278,40395,3275,3011
33005,"Cheshire County, New Hampshire",444,419,0,402,17,25,67900,62989,579,58217,4193,4911,71585,66555,601,61457,4497,5030
33007,"Coos County, New Hampshire",133,133,0,133,0,0,28951,26081,364,22912,2805,2870,29918,26954,372,23681,2901,2964
33009,"Grafton County, New Hampshire",746,743,0,622,121,3,76580,71282,882,64229,6171,5298,82494,77036,914,69210,6912,5458
33011,"Hillsborough County, New Hampshire",9954,9578,9,8927,642,376,340685,325415,1294,309206,14915,15270,397889,380345,1353,360768,18224,17544
33013,"Merrimack County, New Hampshire",1459,1433,0,1377,56,26,132303,123928,805,115271,7852,8375,141309,132538,805,123185,8548,8771
33015,"Rockingham County, New Hampshire",2033,1953,0,1883,70,80,279772,268521,521,256505,11495,11251,299950,288186,521,275206,12459,11764
33017,"Strafford County, New Hampshire",892,837,0,768,69,55,108118,102059,526,94270,7263,6059,117731,111209,543,102503,8163,6522
33019,"Sullivan County, New Hampshire",222,193,0,185,8,29,40490,37207,192,33884,3131,3283,42353,38909,196,35336,3377,3444
34001,"Atlantic County, New Jersey",39967,33790,262,27898,5630,6177,150196,140002,814,130280,8908,10194,266959,245430,1681,221422,22327,21529
34003,"Bergen County, New Jersey",54854,51271,413,47928,2930,3583,534880,504554,1707,487320,15527,30326,926679,881145,2806,848506,29833,45534
34005,"Burlington County, New Jersey",68878,65749,142,61541,4066,3129,301719,286275,1170,274018,11087,15444,437247,416462,1383,396695,18384,20785
34007,"Camden County, New Jersey",96826,86286,147,76163,9976,10540,289740,271363,907,258789,11667,18377,504087,464172,1448,431144,31580,39915
34009,"Cape May County, New Jersey",3919,3322,1,2922,399,597,78937,73015,509,68134,4372,5922,91870,84283,510,78014,5759,7587
34011,"Cumberland County, New Jersey",23926,20279,35,17782,2462,3647,69084,61332,405,56036,4891,7752,142088,122516,703,106941,14872,19572
34013,"Essex County, New Jersey",309420,274002,694,232430,40878,35418,242729,227581,1004,217328,9249,15148,779268,707247,2462,632491,72294,72021
34015,"Gloucester County, New Jersey",29003,26854,172,23433,3249,2149,227665,216817,767,206674,9376,10848,286965,272315,1019,255607,15689,14650
34017,"Hudson County, New Jersey",82049,73307,130,65700,7477,8742,192259,177959,727,169971,7261,14300,672012,620817,2234,572182,46401,51195
34019,"Hunterdon County, New Jersey",1233,1167,4,1071,92,66,107101,102590,617,98600,3373,4511,121158,116261,631,111492,4138,4897
34021,"Mercer County, New Jersey",72395,63941,290,53145,10506,8454,180136,170322,669,161504,8149,9814,355733,330997,1254,300046,29697,24736
34023,"Middlesex County, New Jersey",77670,72971,290,66735,5946,4699,358381,333857,1605,315593,16659,24524,807294,756823,3356,700880,52587,50471
34025,"Monmouth County, New Jersey",44093,40460,72,36294,4094,3633,468547,448233,1240,429880,17113,20314,621200,591951,1545,561576,28830,29249
34027,"Morris County, New Jersey",14771,13884,0,12639,1245,887,353154,339111,1191,327861,10059,14043,489939,471297,1266,454516,15515,18642
34029,"Ocean County, New Jersey",17158,15463,483,13019,1961,1695,495126,451189,2255,405429,43505,43937,582889,532551,2911,478440,51200,50338
34031,"Passaic County, New Jersey",57670,48078,258,41957,5863,9592,210041,194063,786,184781,8496,15978,501387,446433,1477,408241,36715,54954
34033,"Salem County, New Jersey",8170,6636,74,5317,1245,1534,46903,42490,707,39084,2699,4413,62262,55687,804,49988,4895,6575
34035,"Somerset County, New Jersey",30332,28679,211,27008,1460,1653,189512,181603,672,176027,4904,7909,328916,315464,1158,304347,9959,13452
34037,"Sussex County, New Jersey",2539,2472,5,2193,274,67,123768,118216,731,111923,5562,5552,141499,135170,743,127884,6543,6329
34039,"Union County, New Jersey",115360,104001,482,90253,13266,11359,222923,208406,1423,198070,8913,14517,549909,506089,2978,461454,41657,43820
34041,"Warren County, New Jersey",4369,4203,32,3806,365,166,87308,81589,812,77087,3690,5719,104998,98298,986,92104,5208,6700
35001,"Bernalillo County, New Mexico",19153,17342,100,14266,2976,1811,262790,246011,1955,228064,15992,16779,665545,599605,3644,527361,68600,65940
35003,"Catron County, New Mexico",0,0,0,0,0,0,2816,2129,0,1674,455,687,3380,2414,0,1928,486,966
35005,"Chaves County, New Mexico",937,863,0,665,198,74,25680,23331,118,20628,2585,2349,63455,54462,234,46030,8198,8993
35006,"Cibola County, New Mexico",186,186,0,171,15,0,4978,4459,25,3659,775,519,25153,20214,268,14241,5705,4939
35007,"Colfax County, New Mexico",50,50,0,50,0,0,5750,4966,104,4429,433,784,11996,9873,142,8333,1398,2123
35009,"Curry County, New Mexico",2837,2615,0,2157,458,222,24292,22484,131,20527,1826,1808,49231,43546,159,37300,6087,5685
35011,"De Baca County, New Mexico",30,30,0,30,0,0,1046,1001,0,930,71,45,1989,1686,0,1490,196,303
35013,"DoÒa Ana County, New Mexico",3542,3459,0,3034,425,83,58238,54025,558,48625,4842,4213,208547,183104,706,155197,27201,25443
35015,"Eddy County, New Mexico",818,741,0,699,42,77,27208,24764,112,23244,1408,2444,56141,49637,127,45389,4121,6504
35017,"Grant County, New Mexico",216,172,0,112,60,44,12781,11302,163,9735,1404,1479,27664,24128,171,19668,4289,3536
35019,"Guadalupe County, New Mexico",2,2,0,2,0,0,447,248,90,113,45,199,3737,2336,104,1750,482,1401
35021,"Harding County, New Mexico",0,0,0,0,0,0,340,261,0,224,37,79,546,368,0,312,56,178
35023,"Hidalgo County, New Mexico",15,15,0,15,0,0,1773,1632,8,1402,222,141,4351,3550,15,2900,635,801
35025,"Lea County, New Mexico",2419,1993,0,1867,126,426,24982,22543,101,20727,1715,2439,67025,58055,139,52394,5522,8970
35027,"Lincoln County, New Mexico",111,111,0,17,94,0,12289,11060,144,9688,1228,1229,19333,16515,144,13878,2493,2818
35028,"Los Alamos County, New Mexico",42,42,0,42,0,0,13114,12648,64,12362,222,466,17926,17074,95,16298,681,852
35029,"Luna County, New Mexico",329,176,0,108,68,153,7417,6229,183,4773,1273,1188,23915,18732,211,13534,4987,5183
35031,"McKinley County, New Mexico",369,309,22,280,7,60,6353,5729,52,4847,830,624,72115,44379,914,30114,13351,27736
35033,"Mora County, New Mexico",2,2,0,2,0,0,634,418,0,377,41,216,4592,2944,0,2448,496,1648
35035,"Otero County, New Mexico",1815,1596,0,1542,54,219,31529,28902,189,26430,2283,2627,61687,54055,323,47935,5797,7632
35037,"Quay County, New Mexico",133,112,0,19,93,21,4237,3351,16,2800,535,886,8391,6625,47,5729,849,1766
35039,"Rio Arriba County, New Mexico",224,190,0,133,57,34,4809,3844,344,3084,416,965,38793,25805,669,21075,4061,12988
35041,"Roosevelt County, New Mexico",467,467,0,413,54,0,9833,8693,15,7897,781,1140,18132,15879,15,13578,2286,2253
35043,"Sandoval County, New Mexico",2712,2441,18,2251,172,271,61469,58922,681,54523,3718,2547,137919,121583,2031,107989,11563,16336
35045,"San Juan County, New Mexico",703,673,10,618,45,30,49613,43723,523,37491,5709,5890,126547,99744,1989,76864,20891,26803
35047,"San Miguel County, New Mexico",164,164,0,145,19,0,4641,4021,0,3490,531,620,26563,19904,20,15173,4711,6659
35049,"Santa Fe County, New Mexico",964,902,0,857,45,62,62238,59147,579,54982,3586,3091,144528,126917,973,112968,12976,17611
35051,"Sierra County, New Mexico",48,48,0,48,0,0,7222,5838,105,4759,974,1384,11000,8858,137,7372,1349,2142
35053,"Socorro County, New Mexico",0,0,0,0,0,0,5664,4829,71,3958,800,835,16568,12595,240,10714,1641,3973
35055,"Taos County, New Mexico",125,125,0,103,22,0,11374,9990,186,8273,1531,1384,32168,26012,377,20174,5461,6156
35057,"Torrance County, New Mexico",232,232,0,198,34,0,8068,7302,76,6036,1190,766,14909,13296,162,10021,3113,1613
35059,"Union County, New Mexico",40,40,0,40,0,0,2038,1711,6,1386,319,327,3601,2748,9,2220,519,853
35061,"Valencia County, New Mexico",653,383,0,333,50,270,24901,22083,243,19010,2830,2818,74373,60406,598,50499,9309,13967
36001,"Albany County, New York",34778,30381,437,26418,3526,4397,213685,198223,907,187133,10183,15462,291211,269017,1376,249975,17666,22194
36003,"Allegany County, New York",110,104,0,96,8,6,40834,34849,578,30377,3894,5985,42404,36236,621,31618,3997,6168
36005,"Bronx County, New York",472199,423041,1573,357613,63855,49158,127769,110222,743,100316,9163,17547,1413891,1255269,3967,1071226,180076,158622
36007,"Broome County, New York",10303,8641,11,7089,1541,1662,158107,143282,1066,132035,10181,14825,185709,168189,1116,153157,13916,17520
36009,"Cattaraugus County, New York",1063,1006,0,800,206,57,68832,58701,781,50042,7878,10131,75461,64642,824,54887,8931,10819
36011,"Cayuga County, New York",1549,1162,0,887,275,387,69009,61252,488,54928,5836,7757,74074,65583,499,58492,6592,8491
36013,"Chautauqua County, New York",2389,1934,2,1701,231,455,110628,96801,935,85148,10718,13827,124713,109016,937,95312,12767,15697
36015,"Chemung County, New York",3669,2989,15,2323,651,680,72411,66234,423,58953,6858,6177,82060,74818,448,66052,8318,7242
36017,"Chenango County, New York",343,296,0,261,35,47,45692,41125,323,36623,4179,4567,48089,43303,323,38590,4390,4786
36019,"Clinton County, New York",957,914,0,526,388,43,69320,63241,361,56745,6135,6079,73541,67011,396,59718,6897,6530
36021,"Columbia County, New York",2331,2020,18,1402,600,311,51639,47030,374,42471,4185,4609,59000,53795,412,47740,5643,5205
36023,"Cortland County, New York",617,603,0,583,20,14,41758,36688,424,31525,4739,5070,44809,39443,424,33955,5064,5366
36025,"Delaware County, New York",369,331,0,249,82,38,41102,36261,297,32261,3703,4841,43549,38588,312,34199,4077,4961
36027,"Dutchess County, New York",26724,24273,129,21897,2247,2451,203341,192056,954,182097,9005,11285,277097,261020,1179,245929,13912,16077
36029,"Erie County, New York",117758,99430,538,75272,23620,18328,685964,626401,3598,584238,38565,59563,896074,811196,4469,734283,72444,84878
36031,"Essex County, New York",49,49,0,49,0,0,34080,30637,269,27524,2844,3443,35374,31847,269,28338,3240,3527
36033,"Franklin County, New York",344,222,0,161,61,122,39493,33931,324,29772,3835,5562,45112,38939,326,34258,4355,6173
36035,"Fulton County, New York",697,697,0,628,69,0,49573,44147,270,39241,4636,5426,52776,47255,278,41844,5133,5521
36037,"Genesee County, New York",1417,1301,0,999,302,116,52473,47299,286,42996,4017,5174,57756,52300,291,47097,4912,5456
36039,"Greene County, New York",1400,1360,0,1100,260,40,39881,35372,455,31417,3500,4509,44521,39882,474,35379,4029,4639
36041,"Hamilton County, New York",1,0,0,0,0,1,4351,3599,33,3266,300,752,4517,3727,33,3353,341,790
36043,"Herkimer County, New York",554,554,12,324,218,0,58780,51702,674,46265,4763,7078,61698,54483,689,48627,5167,7215
36045,"Jefferson County, New York",5328,4883,0,4608,275,445,92162,85511,300,77380,7831,6651,109841,102205,300,93061,8844,7636
36047,"Kings County, New York",850668,749546,3143,659557,86846,101122,936729,810641,4028,721899,84714,126088,2594550,2290748,10214,2035445,245089,303802
36049,"Lewis County, New York",142,127,0,109,18,15,25492,22622,308,19937,2377,2870,26485,23542,312,20789,2441,2943
36051,"Livingston County, New York",659,576,0,537,39,83,54321,49752,513,45473,3766,4569,58046,53213,513,48620,4080,4833
36053,"Madison County, New York",477,471,35,436,0,6,63633,56917,358,52304,4255,6716,66595,59741,448,54984,4309,6854
36055,"Monroe County, New York",110259,92814,224,79469,13121,17445,512795,476488,2598,450088,23802,36307,721907,660076,3550,610835,45691,61831
36057,"Montgomery County, New York",779,648,0,493,155,131,40004,33969,449,30317,3203,6035,48466,41153,457,36606,4090,7313
36059,"Nassau County, New York",153178,145876,261,136466,9149,7302,823975,784487,1833,755596,27058,39488,1342786,1286408,2461,1230862,53085,56378
36061,"New York County, New York",230232,194596,707,166717,27172,35636,746634,722855,1951,687760,33144,23779,1594032,1458066,4253,1340194,113619,135966
36063,"Niagara County, New York",14822,12246,122,9110,3014,2576,179774,160364,2545,145813,12006,19410,208640,184769,2723,165690,16356,23871
36065,"Oneida County, New York",11922,10252,70,8235,1947,1670,183992,164487,917,151823,11747,19505,219564,195859,1147,177491,17221,23705
36067,"Onondaga County, New York",49451,40604,294,32600,7710,8847,348748,322267,936,296707,24624,26481,448625,408445,1471,368303,38671,40180
36069,"Ontario County, New York",2273,2125,7,1811,307,148,96139,89281,430,83148,5703,6858,105743,97934,454,90752,6728,7809
36071,"Orange County, New York",38340,35736,10,30814,4912,2604,240025,211730,767,188659,22304,28295,367054,330217,1008,289098,40111,36837
36073,"Orleans County, New York",1300,1101,0,937,164,199,34657,30592,213,27598,2781,4065,38576,33944,224,30371,3349,4632
36075,"Oswego County, New York",568,505,0,500,5,63,109571,100996,497,91420,9079,8575,114982,105976,497,96045,9434,9006
36077,"Otsego County, New York",677,617,0,567,50,60,51626,46378,833,41010,4535,5248,55133,49744,833,43960,4951,5389
36079,"Putnam County, New York",1946,1918,0,1865,53,28,78048,75412,153,72930,2329,2636,96775,93645,175,90441,3029,3130
36081,"Queens County, New York",417432,385881,2266,346427,37188,31551,582593,522931,2865,488241,31825,59662,2311908,2124262,8183,1950586,165493,187646
36083,"Rensselaer County, New York",9849,8712,17,7634,1061,1137,129956,120924,479,112515,7930,9032,153867,143189,496,132199,10494,10678
36085,"Richmond County, New York",48063,40779,41,34741,5997,7284,291181,272381,1209,252747,18425,18800,469111,431107,1639,396031,33437,38004
36087,"Rockland County, New York",39110,36346,193,31923,4230,2764,201577,171555,426,149990,21139,30022,318203,280085,892,246055,33138,38118
36089,"St. Lawrence County, New York",583,517,0,437,80,66,94033,82464,536,74494,7434,11569,98938,87071,540,78688,7843,11867
36091,"Saratoga County, New York",3561,3291,0,3170,121,270,202865,191878,750,180669,10459,10987,222411,210872,784,198381,11707,11539
36093,"Schenectady County, New York",15448,13850,20,11714,2116,1598,111382,102789,369,95139,7281,8593,150681,138989,389,127649,10951,11692
36095,"Schoharie County, New York",174,173,0,173,0,1,28682,25413,407,22080,2926,3269,30168,26851,452,23370,3029,3317
36097,"Schuyler County, New York",163,81,0,70,11,82,17056,15030,126,13151,1753,2026,17811,15685,141,13734,1810,2126
36099,"Seneca County, New York",321,312,0,285,27,9,29797,26352,268,23181,2903,3445,31664,28104,272,24760,3072,3560
36101,"Steuben County, New York",1341,1170,0,1069,101,171,90123,79152,1049,68378,9725,10971,95762,84401,1071,73014,10316,11361
36103,"Suffolk County, New York",112415,104745,202,94520,10023,7670,1008852,955249,2606,908331,44312,53603,1466681,1385856,3415,1302635,79806,80825
36105,"Sullivan County, New York",5193,4767,31,4399,337,426,53210,46685,324,43254,3107,6525,71657,63490,382,58859,4249,8167
36107,"Tioga County, New York",211,165,0,165,0,46,46597,41957,284,38659,3014,4640,48774,43774,321,40248,3205,5000
36109,"Tompkins County, New York",2612,2163,0,1964,199,449,70229,65929,459,60300,5170,4300,90661,85506,479,77823,7204,5155
36111,"Ulster County, New York",7997,7092,105,6296,691,905,137754,127416,808,118953,7655,10338,168551,155882,1071,144950,9861,12669
36113,"Warren County, New York",651,565,0,449,116,86,60311,55589,411,52198,2980,4722,63889,58821,414,55015,3392,5068
36115,"Washington County, New York",576,553,0,404,149,23,56420,50139,639,44652,4848,6281,58967,52534,639,46731,5164,6433
36117,"Wayne County, New York",2428,1721,0,1610,111,707,81434,73455,568,65413,7474,7979,89677,80299,573,71303,8423,9378
36119,"Westchester County, New York",135491,123141,168,106438,16535,12350,516216,487876,1436,466872,19568,28340,948937,892045,2082,829904,60059,56892
36121,"Wyoming County, New York",267,267,0,223,44,0,35800,31978,478,28122,3378,3822,37512,33604,478,29479,3647,3908
36123,"Yates County, New York",152,116,6,91,19,36,22835,17538,205,15148,2185,5297,23789,18349,218,15809,2322,5440
37001,"Alamance County, North Carolina",29260,25232,222,20307,4703,4028,99352,90745,285,81326,9134,8607,153336,138816,609,119555,18652,14520
37003,"Alexander County, North Carolina",1556,1438,0,1208,230,118,31757,27277,499,24014,2764,4480,35883,30580,499,26931,3150,5303
37005,"Alleghany County, North Carolina",239,233,0,231,2,6,9423,7934,17,6983,934,1489,10772,9209,17,8084,1108,1563
37007,"Anson County, North Carolina",11418,8968,89,7287,1592,2450,10908,9444,229,7965,1250,1464,23695,19651,318,16269,3064,4044
37009,"Ashe County, North Carolina",66,62,0,52,10,4,24631,20401,204,17994,2203,4230,26410,21930,204,19275,2451,4480
37011,"Avery County, North Carolina",37,37,0,37,0,0,13662,11091,66,9408,1617,2571,14617,11762,66,9807,1889,2855
37013,"Beaufort County, North Carolina",12379,8164,73,6399,1692,4215,30826,26574,228,22919,3427,4252,46838,37718,345,31025,6348,9120
37015,"Bertie County, North Carolina",11514,8027,78,6005,1944,3487,6468,5266,112,4480,674,1202,18560,13722,190,10884,2648,4838
37017,"Bladen County, North Carolina",11696,8866,146,5894,2826,2830,18265,15469,164,13253,2052,2796,33608,27336,329,21723,5284,6272
37019,"Brunswick County, North Carolina",12816,10046,21,8127,1898,2770,99404,92988,1015,82410,9563,6416,121684,111587,1265,97134,13188,10097
37021,"Buncombe County, North Carolina",14960,12374,5,10245,2124,2586,205820,188209,636,174532,13041,17611,245485,222011,757,203324,17930,23474
37023,"Burke County, North Carolina",4244,3211,61,2936,214,1033,71565,59813,756,52411,6646,11752,86060,71627,888,62260,8479,14433
37025,"Cabarrus County, North Carolina",33394,30713,328,28034,2351,2681,132817,126052,488,120029,5535,6765,195189,184500,1119,172437,10944,10689
37027,"Caldwell County, North Carolina",3793,3202,9,2928,265,591,71233,62054,848,55753,5453,9179,80823,70386,887,63133,6366,10437
37029,"Camden County, North Carolina",1460,1237,28,1104,105,223,8297,7767,11,7251,505,530,10302,9549,39,8900,610,753
37031,"Carteret County, North Carolina",3630,3020,66,2333,621,610,58635,54640,470,49847,4323,3995,67614,62597,536,56154,5907,5017
37033,"Caswell County, North Carolina",7066,5413,58,4074,1281,1653,13514,11428,177,10137,1114,2086,21810,17926,235,15200,2491,3884
37035,"Catawba County, North Carolina",12056,9183,13,7645,1525,2873,117253,105543,525,96850,8168,11710,153750,136892,538,124082,12272,16858
37037,"Chatham County, North Carolina",7912,6307,14,4940,1353,1605,48365,44300,407,40957,2936,4065,67565,60839,535,54037,6267,6726
37039,"Cherokee County, North Carolina",280,242,0,242,0,38,24806,20928,237,17959,2732,3878,27012,22879,255,19696,2928,4133
37041,"Chowan County, North Carolina",4770,3443,0,2357,1086,1327,8425,7386,95,6667,624,1039,14116,11658,255,9430,1973,2458
37043,"Clay County, North Carolina",175,145,0,27,118,30,10167,9221,129,7960,1132,946,10703,9713,129,8047,1537,990
37045,"Cleveland County, North Carolina",19953,14241,140,10765,3336,5712,69864,58072,252,49866,7954,11792,95375,76765,447,64629,11689,18610
37047,"Columbus County, North Carolina",16046,10979,105,8146,2728,5067,32582,27173,246,22978,3949,5409,53658,42002,368,33935,7699,11656
37049,"Craven County, North Carolina",21064,17845,25,15171,2649,3219,65147,61095,275,56471,4349,4052,98198,90018,300,81711,8007,8180
37051,"Cumberland County, North Carolina",117808,107014,370,92193,14451,10794,140906,131329,577,122035,8717,9577,317584,293674,1066,264210,28398,23910
37053,"Currituck County, North Carolina",1336,1184,0,1135,49,152,21989,20717,207,18554,1956,1272,25109,23498,239,21198,2061,1611
37055,"Dare County, North Carolina",722,455,0,342,113,267,30873,29687,237,27513,1937,1186,35236,33655,237,30479,2939,1581
37057,"Davidson County, North Carolina",14500,11730,39,9652,2039,2770,131223,116713,629,105409,10675,14510,162125,142249,1113,125345,15791,19876
37059,"Davie County, North Carolina",2474,1920,0,1745,175,554,35180,31928,491,29276,2161,3252,41383,37167,772,33737,2658,4216
37061,"Duplin County, North Carolina",14466,10523,47,7439,3037,3943,30494,26040,90,21856,4094,4454,58807,48285,137,37566,10582,10522
37063,"Durham County, North Carolina",106071,94804,209,84954,9641,11267,121791,116246,545,111232,4469,5545,287149,267347,958,247589,18800,19802
37065,"Edgecombe County, North Carolina",30525,22885,232,17840,4813,7640,19290,16397,63,14163,2171,2893,53134,42227,295,34170,7762,10907
37067,"Forsyth County, North Carolina",91392,77885,180,67295,10410,13507,206553,192234,1169,180268,10797,14319,358127,322826,1879,292105,28842,35301
37069,"Franklin County, North Carolina",15502,11600,28,9666,1906,3902,39870,36860,176,32572,4112,3010,62263,54702,287,47243,7172,7561
37071,"Gaston County, North Carolina",32921,27797,43,24457,3297,5124,155543,137770,899,125355,11516,17773,211162,186767,978,168440,17349,24395
37073,"Gates County, North Carolina",3785,2946,64,1759,1123,839,7234,6354,60,5718,576,880,11546,9817,124,7953,1740,1729
37075,"Graham County, North Carolina",0,0,0,0,0,0,7419,5355,63,4289,1003,2064,8486,6152,89,4858,1205,2334
37077,"Granville County, North Carolina",16547,12967,26,10756,2185,3580,32345,30153,185,27152,2816,2192,54799,48324,218,42121,5985,6475
37079,"Greene County, North Carolina",6469,5509,70,4922,517,960,9006,7914,138,6914,862,1092,18781,16334,208,14272,1854,2447
37081,"Guilford County, North Carolina",165954,137581,783,104501,32297,28373,258249,236066,970,209230,25866,22183,499822,439320,1953,369831,67536,60502
37083,"Halifax County, North Carolina",26849,20319,100,13627,6592,6530,19658,17081,88,14675,2318,2577,50872,40938,206,31012,9720,9934
37085,"Harnett County, North Carolina",26462,23187,13,19352,3822,3275,78040,72683,473,64844,7366,5357,125580,115538,653,100616,14269,10042
37087,"Haywood County, North Carolina",611,495,0,362,133,116,55230,47686,207,39717,7762,7544,59336,51195,207,42554,8434,8141
37089,"Henderson County, North Carolina",3614,2825,9,2542,274,789,92542,83943,374,76703,6866,8599,110723,99627,383,89283,9961,11096
37091,"Hertford County, North Carolina",12090,9111,191,6621,2299,2979,7693,6740,61,5602,1077,953,21444,17359,252,13389,3718,4085
37093,"Hoke County, North Carolina",16934,14518,115,12744,1659,2416,20787,19579,185,18460,934,1208,51143,45251,317,40583,4351,5892
37095,"Hyde County, North Carolina",1251,793,12,419,362,458,3078,2663,233,1773,657,415,4827,3954,367,2469,1118,873
37097,"Iredell County, North Carolina",20838,17275,15,14417,2843,3563,128944,118943,867,106543,11533,10001,168529,153403,882,136184,16337,15126
37099,"Jackson County, North Carolina",819,806,0,393,413,13,30913,27339,402,22318,4619,3574,38144,32814,402,26358,6054,5330
37101,"Johnston County, North Carolina",28080,24480,106,19220,5154,3600,126948,118623,704,105291,12628,8325,184573,170088,1117,145368,23603,14485
37103,"Jones County, North Carolina",2951,2170,55,1295,820,781,5999,5053,8,4284,761,946,9654,7727,63,6005,1659,1927
37105,"Lee County, North Carolina",10941,9090,64,7738,1288,1851,34330,31068,261,28403,2404,3262,58811,51393,325,44827,6241,7418
37107,"Lenoir County, North Carolina",22192,18219,115,16368,1736,3973,28211,25031,208,22948,1875,3180,56602,49041,522,44459,4060,7561
37109,"Lincoln County, North Carolina",4058,3086,0,2268,818,972,68175,61320,397,55974,4949,6855,79772,71160,397,64072,6691,8612
37111,"McDowell County, North Carolina",1366,1156,9,904,243,210,38838,32931,542,28098,4291,5907,43932,37185,551,31865,4769,6747
37113,"Macon County, North Carolina",369,305,0,305,0,64,30315,25581,325,22047,3209,4734,33793,28580,325,24492,3763,5213
37115,"Madison County, North Carolina",65,65,0,59,6,0,19314,16307,141,14184,1982,3007,20239,17012,141,14840,2031,3227
37117,"Martin County, North Carolina",9679,7525,44,5406,2075,2154,12013,10159,272,8585,1302,1854,23077,18843,316,14851,3676,4234
37119,"Mecklenburg County, North Carolina",316873,289224,695,252842,35687,27649,487254,469832,1460,450359,18013,17422,1019212,958087,2469,880193,75425,61125
37121,"Mitchell County, North Carolina",0,0,0,0,0,0,13821,11331,71,9643,1617,2490,14836,11981,71,10273,1637,2855
37123,"Montgomery County, North Carolina",4641,3028,0,2261,767,1613,16905,14381,119,12954,1308,2524,26428,20898,232,18002,2664,5530
37125,"Moore County, North Carolina",11484,9371,37,8087,1247,2113,71701,64783,351,60788,3644,6918,92796,82562,397,76558,5607,10234
37127,"Nash County, North Carolina",35954,29624,245,24416,4963,6330,47251,41852,471,38284,3097,5399,92050,79763,800,69676,9287,12287
37129,"New Hanover County, North Carolina",29945,23926,51,18819,5056,6019,163941,155017,481,144467,10069,8924,212935,195599,575,177918,17106,17336
37131,"Northampton County, North Carolina",11229,8262,44,6108,2110,2967,7562,6192,23,4885,1284,1370,19622,15110,67,11459,3584,4512
37133,"Onslow County, North Carolina",24773,22629,61,18349,4219,2144,115986,109927,354,101690,7883,6059,172107,163041,415,147816,14810,9066
37135,"Orange County, North Carolina",15100,13199,303,10998,1898,1901,91501,88754,353,84372,4029,2747,131259,125715,741,117285,7689,5544
37137,"Pamlico County, North Carolina",2086,1541,0,957,584,545,9199,8304,139,7166,999,895,12114,10651,142,8860,1649,1463
37139,"Pasquotank County, North Carolina",12714,10839,53,8300,2486,1875,21116,18891,149,17389,1353,2225,37213,32722,202,28052,4468,4491
37141,"Pender County, North Carolina",8521,6504,81,4769,1654,2017,42417,39895,692,34885,4318,2522,56445,51233,773,43176,7284,5212
37143,"Perquimans County, North Carolina",3215,2666,154,1847,665,549,9682,8206,74,7451,681,1476,13417,11363,228,9760,1375,2054
37145,"Person County, North Carolina",10464,7489,12,6652,825,2975,25749,23186,164,20619,2403,2563,38722,33102,178,29396,3528,5620
37147,"Pitt County, North Carolina",59436,48669,338,40381,7950,10767,93311,87705,409,78918,8378,5606,170266,152006,747,133498,17761,18260
37149,"Polk County, North Carolina",968,875,0,770,105,93,17728,15715,325,14052,1338,2013,20100,17913,325,15948,1640,2187
37151,"Randolph County, North Carolina",8696,7014,18,5575,1421,1682,112795,96982,942,84592,11448,15813,141393,120970,1102,105061,14807,20423
37153,"Richmond County, North Carolina",13509,10347,76,9097,1174,3162,25637,21574,175,18814,2585,4063,43999,35403,251,31007,4145,8596
37155,"Robeson County, North Carolina",30990,21138,212,13962,6964,9852,33109,26630,182,21580,4868,6479,131013,96932,581,70981,25370,34081
37157,"Rockingham County, North Carolina",16637,12840,118,9255,3467,3797,65546,55826,368,49883,5575,9720,90100,75688,498,65677,9513,14412
37159,"Rowan County, North Carolina",20948,17475,474,12965,4036,3473,99073,89674,665,81980,7029,9399,134685,119375,1139,105012,13224,15310
37161,"Rutherford County, North Carolina",6464,4880,140,3249,1491,1584,54698,45531,462,39098,5971,9167,65322,53802,602,45163,8037,11520
37163,"Sampson County, North Carolina",15729,12202,7,9078,3117,3527,32535,27413,289,23089,4035,5122,62704,52180,380,40760,11040,10524
37165,"Scotland County, North Carolina",12520,9419,201,6015,3203,3101,14771,12254,44,10515,1695,2517,32973,26267,259,20063,5945,6706
37167,"Stanly County, North Carolina",6064,5080,5,4070,1005,984,48215,42758,387,38495,3876,5457,58807,52112,412,46273,5427,6695
37169,"Stokes County, North Carolina",1754,1414,0,1049,365,340,41701,36289,784,31433,4072,5412,45605,39108,815,33722,4571,6497
37171,"Surry County, North Carolina",2534,2055,12,1524,519,479,60290,49670,699,41104,7867,10620,71304,58437,863,47622,9952,12867
37173,"Swain County, North Carolina",19,19,0,0,19,0,8750,5747,108,4519,1120,3003,13933,9359,222,6947,2190,4574
37175,"Transylvania County, North Carolina",1064,896,0,645,251,168,28897,26616,107,23259,3250,2281,32041,29280,107,25260,3913,2761
37177,"Tyrrell County, North Carolina",1065,644,18,485,141,421,1991,1609,0,1408,201,382,3474,2610,18,2224,368,864
37179,"Union County, North Carolina",25150,22833,28,21815,990,2317,160618,154410,600,147569,6241,6208,219952,210479,684,199584,10211,9473
37181,"Vance County, North Carolina",21855,16963,76,12685,4202,4892,17660,15239,73,13382,1784,2421,43611,35929,149,28813,6967,7682
37183,"Wake County, North Carolina",201937,188652,539,166665,21448,13285,607025,591762,1366,567747,22649,15263,1001884,966187,2508,903397,60282,35697
37185,"Warren County, North Carolina",9646,6880,85,4378,2417,2766,7439,6465,81,5363,1021,974,19203,15060,166,11091,3803,4143
37187,"Washington County, North Carolina",5875,4504,0,3503,1001,1371,5458,4322,35,3682,605,1136,12169,9502,35,7681,1786,2667
37189,"Watauga County, North Carolina",515,441,11,430,0,74,44467,41027,238,37021,3768,3440,47862,43913,262,39501,4150,3949
37191,"Wayne County, North Carolina",36849,30732,33,25507,5192,6117,65701,59943,375,54326,5242,5758,121410,107243,415,93887,12941,14167
37193,"Wilkes County, North Carolina",2762,2162,0,1514,648,600,59479,50454,478,44754,5222,9025,67609,56931,478,49339,7114,10678
37195,"Wilson County, North Carolina",31721,25570,70,22519,2981,6151,37672,34038,212,31533,2293,3634,79837,68537,309,60736,7492,11300
37197,"Yadkin County, North Carolina",1232,872,75,684,113,360,31722,26364,167,23279,2918,5358,37490,30946,242,26738,3966,6544
37199,"Yancey County, North Carolina",125,86,0,86,0,39,16213,12727,60,10670,1997,3486,17452,13466,60,11239,2167,3986
38001,"Adams County, North Dakota",39,37,0,37,0,2,2143,1892,0,1776,116,251,2308,2040,0,1918,122,268
38003,"Barnes County, North Dakota",85,85,0,80,5,0,9655,8645,62,7746,837,1010,10380,9287,62,8200,1025,1093
38005,"Benson County, North Dakota",0,0,0,0,0,0,2831,2455,5,2134,316,376,6862,5138,34,3824,1280,1724
38007,"Billings County, North Dakota",9,0,0,0,0,9,902,774,22,698,54,128,951,814,22,738,54,137
38009,"Bottineau County, North Dakota",17,17,0,17,0,0,5913,5342,54,4917,371,571,6350,5768,54,5298,416,582
38011,"Bowman County, North Dakota",3,3,0,3,0,0,2917,2710,19,2436,255,207,3153,2946,19,2657,270,207
38013,"Burke County, North Dakota",10,10,0,10,0,0,2100,1890,6,1605,279,210,2248,2034,6,1693,335,214
38015,"Burleigh County, North Dakota",1487,1426,0,1316,110,61,80554,74915,298,69530,5087,5639,89155,82573,298,76391,5884,6582
38017,"Cass County, North Dakota",7189,5966,52,4874,1040,1223,144051,136644,340,127384,8920,7407,165486,156028,407,143555,12066,9458
38019,"Cavalier County, North Dakota",1,1,0,1,0,0,3570,3195,25,3005,165,375,3719,3344,25,3144,175,375
38021,"Dickey County, North Dakota",48,48,0,16,32,0,4496,4094,36,3735,323,402,4778,4370,36,3979,355,408
38023,"Divide County, North Dakota",23,10,0,10,0,13,2126,1781,27,1546,208,345,2277,1903,27,1656,220,374
38025,"Dunn County, North Dakota",43,43,0,43,0,0,3519,3157,9,2910,238,362,4217,3815,9,3446,360,402
38027,"Eddy County, North Dakota",0,0,0,0,0,0,1980,1729,7,1491,231,251,2225,1901,11,1595,295,324
38029,"Emmons County, North Dakota",0,0,0,0,0,0,3225,2570,15,2096,459,655,3334,2679,15,2150,514,655
38031,"Foster County, North Dakota",5,5,0,5,0,0,3101,2753,59,2499,195,348,3233,2876,59,2621,196,357
38033,"Golden Valley County, North Dakota",0,0,0,0,0,0,1702,1438,8,1212,218,264,1807,1499,8,1273,218,308
38035,"Grand Forks County, North Dakota",2200,2010,0,1452,558,190,55571,52160,203,47907,4050,3411,65378,60692,372,54768,5552,4686
38037,"Grant County, North Dakota",2,2,0,2,0,0,2265,1930,10,1738,182,335,2338,1989,10,1797,182,349
38039,"Griggs County, North Dakota",31,11,0,11,0,20,2092,1806,21,1572,213,286,2179,1858,21,1624,213,321
38041,"Hettinger County, North Dakota",0,0,0,0,0,0,2297,1945,0,1724,221,352,2439,2087,0,1858,229,352
38043,"Kidder County, North Dakota",12,12,0,12,0,0,2305,1985,2,1718,265,320,2457,2137,2,1828,307,320
38045,"LaMoure County, North Dakota",4,4,0,4,0,0,3917,3373,27,2904,442,544,4034,3465,27,2980,458,569
38047,"Logan County, North Dakota",0,0,0,0,0,0,1784,1539,0,1281,258,245,1850,1603,0,1336,267,247
38049,"McHenry County, North Dakota",2,2,0,2,0,0,5596,4962,75,4660,227,634,5876,5202,80,4885,237,674
38051,"McIntosh County, North Dakota",0,0,0,0,0,0,2447,2029,48,1684,297,418,2574,2150,48,1784,318,424
38053,"McKenzie County, North Dakota",63,63,0,49,14,0,8928,8668,65,6940,1663,260,11468,10837,81,8744,2012,631
38055,"McLean County, North Dakota",68,68,0,60,8,0,8442,7632,45,6038,1549,810,9425,8494,45,6520,1929,931
38057,"Mercer County, North Dakota",81,81,0,81,0,0,7907,7154,6,6682,466,753,8494,7692,6,7129,557,802
38059,"Morton County, North Dakota",182,182,0,124,58,0,26750,24697,224,22475,1998,2053,29417,27166,230,24125,2811,2251
38061,"Mountrail County, North Dakota",107,100,0,9,91,7,6174,5656,9,4923,724,518,9869,8817,9,7201,1607,1052
38063,"Nelson County, North Dakota",4,4,0,4,0,0,2804,2445,16,2101,328,359,2893,2529,16,2179,334,364
38065,"Oliver County, North Dakota",7,7,0,7,0,0,1667,1475,0,1391,84,192,1822,1630,0,1523,107,192
38067,"Pembina County, North Dakota",8,8,0,8,0,0,6303,5482,40,4945,497,821,6867,5977,40,5402,535,890
38069,"Pierce County, North Dakota",17,17,0,17,0,0,3900,3337,6,3185,146,563,4097,3516,6,3356,154,581
38071,"Ramsey County, North Dakota",60,60,0,60,0,0,9392,8338,52,7403,883,1054,11062,9759,52,8491,1216,1303
38073,"Ransom County, North Dakota",38,38,0,20,18,0,4992,4444,23,4074,347,548,5259,4706,23,4290,393,553
38075,"Renville County, North Dakota",13,7,0,7,0,6,2292,2115,23,1836,256,177,2490,2297,23,1948,326,193
38077,"Richland County, North Dakota",20,20,2,7,11,0,13919,12617,126,11276,1215,1302,15058,13652,140,11954,1558,1406
38079,"Rolette County, North Dakota",60,55,0,52,3,5,2678,2413,48,2140,225,265,14502,11781,65,9970,1746,2721
38081,"Sargent County, North Dakota",38,38,0,18,20,0,3584,3265,14,2996,255,319,3844,3515,24,3204,287,329
38083,"Sheridan County, North Dakota",0,0,0,0,0,0,1368,1168,15,1013,140,200,1403,1203,15,1036,152,200
38085,"Sioux County, North Dakota",0,0,0,0,0,0,504,393,10,342,41,111,4359,3291,69,2689,533,1068
38087,"Slope County, North Dakota",40,40,0,40,0,0,623,491,11,450,30,132,674,541,11,500,30,133
38089,"Stark County, North Dakota",495,431,0,368,63,64,26144,23966,119,21822,2025,2178,29457,27058,128,24434,2496,2399
38091,"Steele County, North Dakota",0,0,0,0,0,0,1865,1666,37,1503,126,199,1915,1716,37,1553,126,199
38093,"Stutsman County, North Dakota",165,165,0,112,53,0,18217,16470,44,14084,2342,1747,19390,17604,67,14980,2557,1786
38095,"Towner County, North Dakota",0,0,0,0,0,0,2012,1787,41,1558,188,225,2228,1990,41,1749,200,238
38097,"Traill County, North Dakota",44,44,0,44,0,0,7124,6530,10,6022,498,594,7654,7051,10,6531,510,603
38099,"Walsh County, North Dakota",31,31,1,12,18,0,8929,7590,42,6647,901,1339,10515,8892,43,7670,1179,1623
38101,"Ward County, North Dakota",2261,2231,0,2067,164,30,56787,53352,221,50725,2406,3435,67022,63418,230,60202,2986,3604
38103,"Wells County, North Dakota",0,0,0,0,0,0,3910,3373,7,3144,222,537,3987,3450,7,3220,223,537
38105,"Williams County, North Dakota",1095,1095,0,967,128,0,26646,25450,68,22262,3120,1196,32284,30911,68,26501,4342,1373
39001,"Adams County, Ohio",97,97,23,74,0,0,26637,21156,691,16431,4034,5481,27546,21857,714,17055,4088,5689
39003,"Allen County, Ohio",11322,9635,5,7422,2208,1687,81723,74102,605,66473,7024,7621,100093,90402,610,79706,10086,9691
39005,"Ashland County, Ohio",229,227,0,200,27,2,49258,42686,343,38606,3737,6572,51078,44396,343,40159,3894,6682
39007,"Ashtabula County, Ohio",2532,1898,8,1806,84,634,86431,72998,491,65273,7234,13433,95121,80265,531,71874,7860,14856
39009,"Athens County, Ohio",1044,1027,0,800,227,17,50552,44312,407,37636,6269,6240,55842,49249,467,41867,6915,6593
39011,"Auglaize County, Ohio",137,131,0,97,34,6,43439,40250,361,37568,2321,3189,45243,41956,366,39001,2589,3287
39013,"Belmont County, Ohio",1636,1405,0,1152,253,231,61552,53533,664,47092,5777,8019,64802,56442,664,49620,6158,8360
39015,"Brown County, Ohio",318,242,0,79,163,76,41814,36645,460,31478,4707,5169,43223,37915,460,32481,4974,5308
39017,"Butler County, Ohio",28702,26382,0,23715,2667,2320,299050,279320,1243,261039,17038,19730,364032,339842,1411,314202,24229,24190
39019,"Carroll County, Ohio",227,227,4,223,0,0,26408,22494,422,19699,2373,3914,27373,23438,426,20546,2466,3935
39021,"Champaign County, Ohio",447,421,5,358,58,26,35859,33000,129,30487,2384,2859,38142,35198,134,32510,2554,2944
39023,"Clark County, Ohio",10632,9106,52,8175,879,1526,111861,101518,367,91523,9628,10343,132307,119522,419,107505,11598,12785
39025,"Clermont County, Ohio",2718,2567,26,2194,347,151,188194,176258,1123,161673,13462,11936,200264,187266,1155,171646,14465,12998
39027,"Clinton County, Ohio",761,693,0,586,107,68,38153,34340,551,30083,3706,3813,40668,36714,551,32297,3866,3954
39029,"Columbiana County, Ohio",1375,1079,0,916,163,296,96161,85914,944,74588,10382,10247,100722,89977,1012,77868,11097,10745
39031,"Coshocton County, Ohio",380,338,0,338,0,42,34736,27923,311,23904,3708,6813,36139,29178,311,25007,3860,6961
39033,"Crawford County, Ohio",327,321,0,314,7,6,39961,35089,486,31224,3379,4872,41689,36636,486,32696,3454,5053
39035,"Cuyahoga County, Ohio",362868,303618,1565,246764,55289,59250,733341,670027,3078,627998,38951,63314,1228706,1097158,5143,986131,105884,131548
39037,"Darke County, Ohio",376,366,0,287,79,10,49387,43994,475,39044,4475,5393,51238,45690,479,40527,4684,5548
39039,"Defiance County, Ohio",650,434,0,317,117,216,32821,29916,516,27524,1876,2905,37694,34172,516,31303,2353,3522
39041,"Delaware County, Ohio",6108,5870,73,5571,226,238,164954,160506,465,153857,6184,4448,190385,185591,594,177739,7258,4794
39043,"Erie County, Ohio",6188,5304,9,4297,998,884,61992,56323,420,51854,4049,5669,74039,67218,455,61002,5761,6821
39045,"Fairfield County, Ohio",10077,9799,0,9277,522,278,130011,121257,950,112914,7393,8754,148645,139451,969,129676,8806,9194
39047,"Fayette County, Ohio",509,353,0,335,18,156,26270,22767,86,18722,3959,3503,28248,24293,86,20090,4117,3955
39049,"Franklin County, Ohio",271121,243039,960,207861,34218,28082,788131,743677,2149,706492,35036,44454,1225885,1142255,3804,1055445,83006,83630
39051,"Fulton County, Ohio",73,73,0,73,0,0,37420,34353,450,31244,2659,3067,41824,38590,500,34963,3127,3234
39053,"Gallia County, Ohio",663,474,7,422,45,189,27653,22784,439,18777,3568,4869,29369,24171,446,19929,3796,5198
39055,"Geauga County, Ohio",1098,1051,0,983,68,47,89034,75199,308,70664,4227,13835,92898,78806,428,74017,4361,14092
39057,"Greene County, Ohio",8767,8078,0,7095,983,689,132807,124587,567,115895,8125,8220,155666,146355,576,135800,9979,9311
39059,"Guernsey County, Ohio",434,302,7,288,7,132,36878,31325,355,27265,3705,5553,38863,33039,480,28674,3885,5824
39061,"Hamilton County, Ohio",203322,171687,785,143468,27434,31635,520440,485095,3501,455532,26062,35345,790281,716641,4498,652510,59633,73640
39063,"Hancock County, Ohio",906,825,0,719,106,81,66030,61423,533,55538,5352,4607,73591,68161,566,61190,6405,5430
39065,"Hardin County, Ohio",108,95,0,77,18,13,28109,23548,181,20385,2982,4561,29256,24559,181,21289,3089,4697
39067,"Harrison County, Ohio",280,254,0,254,0,26,14423,11737,158,10508,1071,2686,15129,12383,158,11133,1092,2746
39069,"Henry County, Ohio",113,107,0,82,25,6,24404,22623,212,20597,1814,1781,27027,25092,221,22948,1923,1935
39071,"Highland County, Ohio",569,432,0,370,62,137,40638,33453,268,27587,5598,7185,42492,34971,311,28713,5947,7521
39073,"Hocking County, Ohio",216,195,0,123,72,21,26984,23800,430,19974,3396,3184,27858,24599,430,20690,3479,3259
39075,"Holmes County, Ohio",13,13,0,13,0,0,42098,24108,240,19456,4412,17990,42925,24864,272,20050,4542,18061
39077,"Huron County, Ohio",843,816,0,809,7,27,52417,47338,715,41923,4700,5079,57561,51902,755,46067,5080,5659
39079,"Jackson County, Ohio",257,226,0,226,0,31,31024,27011,389,22650,3972,4013,32269,28192,424,23396,4372,4077
39081,"Jefferson County, Ohio",3705,2983,0,2738,245,722,58911,50919,423,46564,3932,7992,64928,56011,423,51262,4326,8917
39083,"Knox County, Ohio",489,392,0,361,31,97,55097,48188,529,43896,3763,6909,57442,50266,529,45797,3940,7176
39085,"Lake County, Ohio",8638,7809,0,7303,506,829,202053,187808,1084,177165,9559,14245,226518,210091,1084,197776,11231,16427
39087,"Lawrence County, Ohio",1083,900,0,572,328,183,57360,49153,641,41932,6580,8207,60373,51715,641,44005,7069,8658
39089,"Licking County, Ohio",5810,5648,28,5318,302,162,152610,141720,997,130970,9753,10890,166890,155501,1057,143555,10889,11389
39091,"Logan County, Ohio",731,595,0,509,86,136,42095,37003,203,33181,3619,5092,44909,39531,203,35405,3923,5378
39093,"Lorain County, Ohio",23247,20141,35,16626,3480,3106,235134,217125,1501,200819,14805,18009,296062,270356,1697,245575,23084,25706
39095,"Lucas County, Ohio",79782,69676,407,54662,14607,10106,294286,270955,1012,248519,21424,23331,423581,387522,1550,343812,42160,36059
39097,"Madison County, Ohio",571,550,0,454,96,21,36141,33142,112,29949,3081,2999,38638,35478,112,32043,3323,3160
39099,"Mahoning County, Ohio",33470,28732,135,23119,5478,4738,173132,154945,929,142680,11336,18187,224938,200091,1095,180472,18524,24847
39101,"Marion County, Ohio",1334,1147,0,929,218,187,55103,49003,262,44281,4460,6100,59732,53385,301,47949,5135,6347
39103,"Medina County, Ohio",2571,2338,0,1819,519,233,164838,156112,805,147787,7520,8726,174983,165875,805,156712,8358,9108
39105,"Meigs County, Ohio",257,204,0,163,41,53,22283,19018,157,15786,3075,3265,23008,19565,157,16270,3138,3443
39107,"Mercer County, Ohio",240,240,0,229,11,0,38561,35493,328,33024,2141,3068,40227,37073,328,34307,2438,3154
39109,"Miami County, Ohio",2113,1882,19,1631,232,231,95794,88112,527,80542,7043,7682,103106,94727,546,86319,7862,8379
39111,"Monroe County, Ohio",1,1,0,0,1,0,13943,11117,231,9458,1428,2826,14088,11233,231,9523,1479,2855
39113,"Montgomery County, Ohio",107095,90674,316,75893,14465,16421,366511,338332,1801,312791,23740,28179,515145,468347,2153,424949,41245,46798
39115,"Morgan County, Ohio",505,438,8,352,78,67,13474,11133,439,9294,1400,2341,14598,12084,491,10037,1556,2514
39117,"Morrow County, Ohio",204,204,0,204,0,0,33334,29651,416,25979,3256,3683,34630,30746,416,26992,3338,3884
39119,"Muskingum County, Ohio",2488,2085,0,1808,277,403,77252,68605,796,60600,7209,8647,84006,74784,828,65858,8098,9222
39121,"Noble County, Ohio",40,40,0,40,0,0,11766,8958,128,7801,1029,2808,11957,9143,128,7986,1029,2814
39123,"Ottawa County, Ohio",289,275,0,234,41,14,37076,34335,471,30690,3174,2741,39946,37048,471,33128,3449,2898
39125,"Paulding County, Ohio",120,118,9,95,14,2,17479,15253,127,13698,1428,2226,18863,16551,140,14842,1569,2312
39127,"Perry County, Ohio",106,104,0,90,14,2,34544,29471,610,24185,4676,5073,35646,30404,610,24929,4865,5242
39129,"Pickaway County, Ohio",235,221,0,209,12,14,50407,45439,285,41363,3791,4968,52308,47303,285,43160,3858,5005
39131,"Pike County, Ohio",317,305,0,197,108,12,26556,22487,138,19007,3342,4069,27821,23650,138,20007,3505,4171
39133,"Portage County, Ohio",5809,5394,25,4391,978,415,140821,130867,827,117874,12166,9954,155184,144126,852,128726,14548,11058
39135,"Preble County, Ohio",146,146,0,124,22,0,39616,35600,486,31475,3639,4016,40905,36747,486,32589,3672,4158
39137,"Putnam County, Ohio",61,61,0,61,0,0,31219,28722,211,26439,2072,2497,33732,30940,221,28179,2540,2792
39139,"Richland County, Ohio",6798,5615,41,4420,1154,1183,101003,88542,600,77274,10668,12461,114392,99959,698,86817,12444,14433
39141,"Ross County, Ohio",1956,1692,0,1393,299,264,65526,57880,365,50413,7102,7646,71141,62966,365,54737,7864,8175
39143,"Sandusky County, Ohio",1483,1278,0,1169,109,205,49709,44574,332,38297,5945,5135,58269,52549,332,45013,7204,5720
39145,"Scioto County, Ohio",1198,897,0,808,89,301,69524,58473,1345,50942,6186,11051,73256,61553,1636,53420,6497,11703
39147,"Seneca County, Ohio",1018,834,0,490,344,184,47836,43215,398,38774,4043,4621,52532,47438,400,42200,4838,5094
39149,"Shelby County, Ohio",1298,862,0,666,196,436,45237,41193,379,36847,3967,4044,48445,43757,379,38844,4534,4688
39151,"Stark County, Ohio",25421,21812,22,19642,2148,3609,317387,288864,1273,270993,16598,28523,365138,331173,1295,309341,20537,33965
39153,"Summit County, Ohio",76340,64985,236,53945,10804,11355,414387,380341,2270,352335,25736,34046,531935,482912,2765,440660,39487,49023
39155,"Trumbull County, Ohio",15683,11816,146,8466,3204,3867,175254,150599,1395,134823,14381,24655,199381,170049,1574,149990,18485,29332
39157,"Tuscarawas County, Ohio",796,755,0,716,39,41,86918,74127,621,66988,6518,12791,91446,78015,632,69920,7463,13431
39159,"Union County, Ohio",774,682,7,666,9,92,46946,44039,499,41167,2373,2907,51481,48198,561,45205,2432,3283
39161,"Van Wert County, Ohio",307,301,0,204,97,6,26388,23757,295,20057,3405,2631,27944,25214,325,21140,3749,2730
39163,"Vinton County, Ohio",53,53,0,23,30,0,12630,10144,115,7780,2249,2486,13041,10514,129,7971,2414,2527
39165,"Warren County, Ohio",5031,4856,0,4469,387,175,190865,182378,401,174617,7360,8487,216750,207531,401,198570,8560,9219
39167,"Washington County, Ohio",575,408,72,309,27,167,56761,47809,485,42200,5124,8952,59178,49804,572,43958,5274,9374
39169,"Wayne County, Ohio",1344,1270,0,1006,264,74,105691,89097,639,81344,7114,16594,112112,95007,679,86588,7740,17105
39171,"Williams County, Ohio",55,51,0,47,4,4,33750,30554,278,27830,2446,3196,35801,32523,278,29634,2611,3278
39173,"Wood County, Ohio",2644,2557,0,2273,284,87,109566,102931,984,94641,7306,6635,122541,115387,1053,105854,8480,7154
39175,"Wyandot County, Ohio",56,56,0,56,0,0,20882,18581,142,16219,2220,2301,21900,19510,142,17119,2249,2390
40001,"Adair County, Oklahoma",65,60,0,39,21,5,8958,6958,126,5015,1817,2000,22025,16731,279,11417,5035,5294
40003,"Alfalfa County, Oklahoma",6,6,0,4,2,0,4134,3626,41,3211,374,508,4825,4235,41,3788,406,590
40005,"Atoka County, Oklahoma",196,74,0,67,7,122,9140,7738,98,6514,1126,1402,12253,10346,133,8712,1501,1907
40007,"Beaver County, Oklahoma",0,0,0,0,0,0,4106,3587,32,3310,245,519,5363,4619,32,4066,521,744
40009,"Beckham County, Oklahoma",275,209,0,132,77,66,16845,15200,35,12840,2325,1645,21235,19295,35,16062,3198,1940
40011,"Blaine County, Oklahoma",170,161,6,85,70,9,6545,5605,51,4521,1033,940,8158,6717,58,5251,1408,1441
40013,"Bryan County, Oklahoma",794,711,4,448,259,83,31685,27736,208,22709,4819,3949,43984,38676,281,31027,7368,5308
40015,"Caddo County, Oklahoma",608,496,0,415,81,112,16652,14058,83,11112,2863,2594,28402,23417,125,17980,5312,4985
40017,"Canadian County, Oklahoma",2749,2508,0,2005,503,241,101538,96050,330,87256,8464,5488,130796,123875,333,110604,12938,6921
40019,"Carter County, Oklahoma",2969,2080,51,1401,628,889,33628,29562,109,23529,5924,4066,47506,41323,182,31832,9309,6183
40021,"Cherokee County, Oklahoma",480,428,0,267,161,52,22189,17776,187,14309,3280,4413,46436,37654,357,29363,7934,8782
40023,"Choctaw County, Oklahoma",1678,834,0,595,239,844,9051,6646,43,5277,1326,2405,14794,10522,51,8368,2103,4272
40025,"Cimarron County, Oklahoma",0,0,0,0,0,0,1716,1496,0,1221,275,220,2197,1904,0,1498,406,293
40027,"Cleveland County, Oklahoma",11660,11154,74,9965,1115,506,191437,181269,979,167198,13092,10168,262020,248905,1159,229624,18122,13115
40029,"Coal County, Oklahoma",9,6,0,6,0,3,3891,3034,40,2570,424,857,5599,4453,64,3739,650,1146
40031,"Comanche County, Oklahoma",19230,17229,84,14257,2888,2001,65324,60266,299,53629,6338,5058,114122,104957,424,92089,12444,9165
40033,"Cotton County, Oklahoma",89,75,0,67,8,14,4516,3934,68,3326,540,582,5873,5148,68,4223,857,725
40035,"Craig County, Oklahoma",236,100,0,100,0,136,8763,7229,55,5732,1442,1534,13468,11194,89,8748,2357,2274
40037,"Creek County, Oklahoma",1501,1081,0,880,201,420,53705,46518,229,42423,3866,7187,70068,60255,323,54721,5211,9813
40039,"Custer County, Oklahoma",687,495,0,364,131,192,19222,17900,130,15542,2228,1322,27500,25263,141,20795,4327,2237
40041,"Delaware County, Oklahoma",80,80,0,39,41,0,26601,23405,165,19556,3684,3196,41421,36094,251,29365,6478,5327
40043,"Dewey County, Oklahoma",0,0,0,0,0,0,4003,3499,15,2939,545,504,4805,4225,15,3447,763,580
40045,"Ellis County, Oklahoma",0,0,0,0,0,0,3517,3015,66,2416,533,502,4049,3514,66,2757,691,535
40047,"Garfield County, Oklahoma",1867,1707,0,1398,309,160,45996,40899,150,36360,4389,5097,60704,53711,165,46696,6850,6993
40049,"Garvin County, Oklahoma",637,531,3,453,75,106,20955,18171,165,15437,2569,2784,27409,23900,173,20402,3325,3509
40051,"Grady County, Oklahoma",1120,914,0,471,443,206,44111,39513,330,30647,8536,4598,53664,48122,343,37456,10323,5542
40053,"Grant County, Oklahoma",4,2,0,2,0,2,3913,3416,39,2978,399,497,4377,3739,41,3277,421,638
40055,"Greer County, Oklahoma",238,203,0,190,13,35,3990,3447,23,3134,290,543,4965,4328,56,3935,337,637
40057,"Harmon County, Oklahoma",190,94,0,84,10,96,1571,1459,25,1258,176,112,2655,2309,25,2021,263,346
40059,"Harper County, Oklahoma",0,0,0,0,0,0,2835,2515,0,2070,445,320,3785,3369,61,2631,677,416
40061,"Haskell County, Oklahoma",103,87,0,71,16,16,8996,7421,23,6058,1340,1575,12665,10560,23,8675,1862,2105
40063,"Hughes County, Oklahoma",267,234,29,185,20,33,7875,5941,291,4666,984,1934,11803,8665,529,6576,1560,3138
40065,"Jackson County, Oklahoma",1724,1453,100,1153,200,271,15835,14390,29,13148,1213,1445,24909,22273,141,19648,2484,2636
40067,"Jefferson County, Oklahoma",62,55,0,45,10,7,4849,3893,51,3060,782,956,6112,4957,51,3804,1102,1155
40069,"Johnston County, Oklahoma",97,65,0,65,0,32,7557,6298,58,4809,1431,1259,10765,8853,76,6883,1894,1912
40071,"Kay County, Oklahoma",784,585,0,396,189,199,33492,29579,360,22725,6494,3913,44265,38721,428,29397,8896,5544
40073,"Kingfisher County, Oklahoma",155,126,0,120,6,29,11841,10835,178,8940,1717,1006,15341,13748,202,10645,2901,1593
40075,"Kiowa County, Oklahoma",276,204,0,153,51,72,6710,5800,14,5041,745,910,8929,7608,14,6611,983,1321
40077,"Latimer County, Oklahoma",68,63,5,58,0,5,6737,5512,122,4481,909,1225,10231,8469,193,6633,1643,1762
40079,"Le Flore County, Oklahoma",968,696,15,512,169,272,35035,27380,219,23426,3735,7655,48494,38293,307,32878,5108,10201
40081,"Lincoln County, Oklahoma",588,510,0,288,222,78,28513,24067,472,18402,5193,4446,34364,29393,539,22539,6315,4971
40083,"Logan County, Oklahoma",3368,2465,6,2036,423,903,34299,30963,150,27871,2942,3336,43466,38506,170,34426,3910,4960
40085,"Love County, Oklahoma",173,124,0,124,0,49,7030,5967,112,4559,1296,1063,9729,8249,112,6097,2040,1480
40087,"McClain County, Oklahoma",380,332,0,332,0,48,30016,28040,108,25831,2101,1976,37645,35146,134,32236,2776,2499
40089,"McCurtain County, Oklahoma",2563,1413,9,1047,357,1150,20576,15202,93,12570,2539,5374,32585,23270,126,18819,4325,9315
40091,"McIntosh County, Oklahoma",537,422,0,337,85,115,13315,11090,209,8255,2626,2225,19545,16041,229,11857,3955,3504
40093,"Major County, Oklahoma",25,25,0,25,0,0,6513,5658,86,4736,836,855,7621,6531,86,5496,949,1090
40095,"Marshall County, Oklahoma",208,182,0,101,81,26,10595,9089,6,6569,2514,1506,15950,13832,80,9477,4275,2118
40097,"Mayes County, Oklahoma",160,115,0,103,12,45,26350,22915,192,19146,3577,3435,40355,35430,226,29470,5734,4925
40099,"Murray County, Oklahoma",167,101,0,101,0,66,9818,8874,31,7075,1768,944,13417,12005,46,9066,2893,1412
40101,"Muskogee County, Oklahoma",6715,5049,33,3151,1865,1666,37305,31801,216,25953,5632,5504,65793,55899,351,44154,11394,9894
40103,"Noble County, Oklahoma",76,8,0,8,0,68,9136,7917,32,6662,1223,1219,11164,9598,46,7929,1623,1566
40105,"Nowata County, Oklahoma",213,143,0,111,32,70,6845,5787,24,4376,1387,1058,10254,8701,49,6490,2162,1553
40107,"Okfuskee County, Oklahoma",541,389,0,232,157,152,6680,5316,49,4217,1050,1364,10815,8605,95,6731,1779,2210
40109,"Oklahoma County, Oklahoma",112870,95488,269,77151,18068,17382,430256,400200,1442,363837,34921,30056,757830,689681,2139,607108,80434,68149
40111,"Okmulgee County, Oklahoma",3180,2277,3,1771,503,903,23607,20119,225,16821,3073,3488,37707,31605,235,25808,5562,6102
40113,"Osage County, Oklahoma",4987,4480,10,3643,827,507,29474,25766,192,21641,3933,3708,45944,40412,237,33836,6339,5532
40115,"Ottawa County, Oklahoma",123,109,0,87,22,14,20197,16012,118,12908,2986,4185,30662,24383,183,19566,4634,6279
40117,"Pawnee County, Oklahoma",130,86,0,73,13,44,12561,10488,109,8273,2106,2073,16237,13476,113,10469,2894,2761
40119,"Payne County, Oklahoma",2450,2109,0,1836,273,341,57312,52567,197,47343,5027,4745,72651,66566,219,59705,6642,6085
40121,"Pittsburg County, Oklahoma",1052,942,0,917,25,110,30142,25973,185,22262,3526,4169,42476,36838,201,31271,5366,5638
40123,"Pontotoc County, Oklahoma",701,602,0,479,123,99,24401,20744,510,17312,2922,3657,36851,30893,811,25040,5042,5958
40125,"Pottawatomie County, Oklahoma",1962,1654,42,1095,517,308,50209,44482,361,36587,7534,5727,68361,59921,483,48469,10969,8440
40127,"Pushmataha County, Oklahoma",87,70,3,54,13,17,7939,6259,46,5413,800,1680,11016,8659,58,7381,1220,2357
40129,"Roger Mills County, Oklahoma",4,4,0,0,4,0,3140,2714,21,2258,435,426,3715,3224,21,2589,614,491
40131,"Rogers County, Oklahoma",843,795,0,671,124,48,64229,59937,286,51836,7815,4292,88840,83164,371,70948,11845,5676
40133,"Seminole County, Oklahoma",1157,869,66,622,181,288,15990,13404,208,10616,2580,2586,24595,20351,385,15976,3990,4244
40135,"Sequoyah County, Oklahoma",807,690,0,584,106,117,26069,22182,240,18016,3926,3887,41005,35000,311,28200,6489,6005
40137,"Stephens County, Oklahoma",756,563,0,402,161,193,35384,31040,361,26173,4506,4344,43732,38326,401,32111,5814,5406
40139,"Texas County, Oklahoma",795,568,0,292,276,227,9440,8620,30,7062,1528,820,20889,17083,224,12956,3903,3806
40141,"Tillman County, Oklahoma",570,404,0,338,66,166,4445,3895,59,3309,527,550,7226,5999,59,5125,815,1227
40143,"Tulsa County, Oklahoma",62428,51684,82,42555,9047,10744,396480,369931,1149,341988,26794,26549,629020,575347,1678,519086,54583,53673
40145,"Wagoner County, Oklahoma",2660,2403,0,2047,356,257,55247,51941,253,47599,4089,3306,76561,71878,321,65514,6043,4683
40147,"Washington County, Oklahoma",1256,1065,0,899,166,191,37635,33892,120,30093,3679,3743,51098,45924,180,40191,5553,5174
40149,"Washita County, Oklahoma",12,9,0,9,0,3,9485,8666,149,6960,1557,819,11293,10294,165,8079,2050,999
40151,"Woods County, Oklahoma",153,124,0,124,0,29,7251,6508,53,5845,610,743,8287,7502,53,6630,819,785
40153,"Woodward County, Oklahoma",38,38,0,19,19,0,16490,15109,109,13110,1890,1381,20054,18514,112,16163,2239,1540
41001,"Baker County, Oregon",121,121,0,96,25,0,14126,12520,160,10964,1396,1606,15403,13619,160,11757,1702,1784
41003,"Benton County, Oregon",859,777,8,729,40,82,67727,65711,308,61712,3691,2016,82595,80080,357,74998,4725,2515
41005,"Clackamas County, Oregon",3859,3828,0,3757,71,31,328504,313814,1722,294618,17474,14690,396932,379372,1975,354909,22488,17560
41007,"Clatsop County, Oregon",167,167,0,167,0,0,32197,29668,58,27071,2539,2529,37199,34314,80,31386,2848,2885
41009,"Columbia County, Oregon",225,158,0,117,41,67,44447,41101,423,38072,2606,3346,49804,46273,423,42988,2862,3531
41011,"Coos County, Oregon",687,300,0,247,53,387,52996,47214,647,40614,5953,5782,61855,54872,668,47507,6697,6983
41013,"Crook County, Oregon",97,75,0,75,0,22,19086,17515,107,16087,1321,1571,21584,19780,166,17946,1668,1804
41015,"Curry County, Oregon",72,72,0,16,56,0,19198,16979,213,15485,1281,2219,22097,19711,225,17975,1511,2386
41017,"Deschutes County, Oregon",950,950,0,896,54,0,152735,146128,626,132089,13413,6607,174030,165921,698,148829,16394,8109
41019,"Douglas County, Oregon",403,369,0,338,31,34,93826,84924,1163,75360,8401,8902,105780,95906,1274,85304,9328,9874
41021,"Gilliam County, Oregon",0,0,0,0,0,0,1628,1395,38,1177,180,233,1895,1640,38,1422,180,255
41023,"Grant County, Oregon",18,18,0,10,8,0,6489,5749,68,5119,562,740,7025,6243,68,5539,636,782
41025,"Harney County, Oregon",47,47,0,29,18,0,6148,5505,54,4718,733,643,7021,6210,54,5332,824,811
41027,"Hood River County, Oregon",27,27,0,14,13,0,14554,13710,227,12629,854,844,21931,20198,316,17746,2136,1733
41029,"Jackson County, Oregon",1244,1187,0,1032,155,57,170303,159100,970,146672,11458,11203,208378,194616,1112,177977,15527,13762
41031,"Jefferson County, Oregon",113,90,0,48,42,23,13117,12103,19,10953,1131,1014,21891,19531,52,16848,2631,2360
41033,"Josephine County, Oregon",281,267,0,267,0,14,72923,65948,910,60100,4938,6975,83339,75813,1021,68311,6481,7526
41035,"Klamath County, Oregon",487,487,0,463,24,0,51240,46128,245,41374,4509,5112,64947,58566,294,51828,6444,6381
41037,"Lake County, Oregon",0,0,0,0,0,0,6251,5356,3,4366,987,895,7240,6116,3,5042,1071,1124
41039,"Lane County, Oregon",3894,3734,0,3413,321,160,294496,277558,2202,252004,23352,16938,355568,336208,2356,304285,29567,19360
41041,"Lincoln County, Oregon",182,158,0,132,26,24,38761,35096,345,31097,3654,3665,46728,42664,388,37653,4623,4064
41043,"Linn County, Oregon",436,429,0,429,0,7,102756,95361,516,85745,9100,7395,119757,110873,544,99648,10681,8884
41045,"Malheur County, Oregon",79,79,0,65,14,0,16458,14662,216,12564,1882,1796,26810,23512,273,19420,3819,3298
41047,"Marion County, Oregon",3226,3026,0,2377,649,200,212609,199817,1988,184333,13496,12792,319905,297180,2335,270014,24831,22725
41049,"Morrow County, Oregon",33,33,0,4,29,0,6737,6087,44,5693,350,650,11100,9865,92,8408,1365,1235
41051,"Multnomah County, Oregon",41708,36744,67,31728,4949,4964,543244,519804,2184,488359,29261,23440,769759,729393,2984,676605,49804,40366
41053,"Polk County, Oregon",757,606,0,582,24,151,61551,58473,783,54006,3684,3078,77921,73913,814,68263,4836,4008
41055,"Sherman County, Oregon",13,13,0,10,3,0,1490,1332,13,1219,100,158,1622,1454,13,1307,134,168
41057,"Tillamook County, Oregon",56,56,0,49,7,0,21465,19606,176,17442,1988,1859,25164,22825,194,20159,2472,2339
41059,"Umatilla County, Oregon",275,262,0,210,52,13,48272,43506,187,38889,4430,4766,71970,64677,209,57414,7054,7293
41061,"Union County, Oregon",197,173,0,141,32,24,22480,20717,228,18217,2272,1763,25020,22857,234,20076,2547,2163
41063,"Wallowa County, Oregon",15,15,0,7,8,0,6294,5645,22,4929,694,649,6729,6044,22,5273,749,685
41065,"Wasco County, Oregon",137,137,0,137,0,0,18617,16715,326,14576,1813,1902,24492,22055,344,19115,2596,2437
41067,"Washington County, Oregon",10767,10597,0,10125,472,170,379241,366883,1021,346985,18877,12358,564971,545815,1422,510533,33860,19156
41069,"Wheeler County, Oregon",0,0,0,0,0,0,1247,1080,4,964,112,167,1397,1230,4,1110,116,167
41071,"Yamhill County, Oregon",540,494,0,494,0,46,76144,71918,725,65561,5632,4226,97015,91527,847,83166,7514,5488
42001,"Adams County, Pennsylvania",1267,1188,0,1113,75,79,87476,79542,992,72082,6468,7934,97462,88778,999,79771,8008,8684
42003,"Allegheny County, Pennsylvania",152616,132731,448,109269,23014,19885,947088,866276,4668,816801,44807,80812,1193967,1089023,5259,1009390,74374,104944
42005,"Armstrong County, Pennsylvania",480,457,0,432,25,23,64330,55958,897,51275,3786,8372,65989,57533,921,52704,3908,8456
42007,"Beaver County, Pennsylvania",9514,7992,84,7253,655,1522,148456,133093,923,124313,7857,15363,165191,147785,1044,137830,8911,17406
42009,"Bedford County, Pennsylvania",162,141,0,113,28,21,46924,39397,653,35922,2822,7527,48360,40675,672,37006,2997,7685
42011,"Berks County, Pennsylvania",19118,17312,40,16046,1226,1806,294926,267741,3076,250122,14543,27185,401911,365357,3199,339535,22623,36554
42013,"Blair County, Pennsylvania",1623,1448,19,1056,373,175,115488,100661,484,91628,8549,14827,121491,106219,596,96174,9449,15272
42015,"Bradford County, Pennsylvania",307,264,11,226,27,43,58421,51529,863,46303,4363,6892,60747,53698,903,48251,4544,7049
42017,"Bucks County, Pennsylvania",23518,21601,14,19616,1971,1917,523760,496420,1666,477280,17474,27340,616879,584740,1759,559369,23612,32139
42019,"Butler County, Pennsylvania",1168,1139,0,1054,85,29,171967,158488,927,149195,8366,13479,180217,166491,932,156812,8747,13726
42021,"Cambria County, Pennsylvania",3334,2773,80,2376,317,561,120663,104827,1188,96864,6775,15836,128301,111570,1269,102806,7495,16731
42023,"Cameron County, Pennsylvania",47,47,0,0,47,0,4519,3822,20,3613,189,697,4666,3963,20,3675,268,703
42025,"Carbon County, Pennsylvania",1038,902,0,669,233,136,58434,52452,704,47357,4391,5982,63084,56822,704,51133,4985,6262
42027,"Centre County, Pennsylvania",3969,3910,6,3086,818,59,125432,115167,959,106185,8023,10265,142885,132164,993,121074,10097,10721
42029,"Chester County, Pennsylvania",26752,23000,0,21023,1977,3752,404265,382401,1096,367781,13524,21864,500300,466507,1144,443331,22032,33793
42031,"Clarion County, Pennsylvania",325,325,0,243,82,0,36161,30957,396,28035,2526,5204,37381,32135,409,29046,2680,5246
42033,"Clearfield County, Pennsylvania",271,268,0,133,135,3,72877,62055,938,54610,6507,10822,74977,63871,946,56126,6799,11106
42035,"Clinton County, Pennsylvania",257,254,0,189,65,3,35953,30821,497,27352,2972,5132,37356,32130,506,28372,3252,5226
42037,"Columbia County, Pennsylvania",683,651,0,493,158,32,58521,50675,448,46353,3874,7846,62121,54046,450,49369,4227,8075
42039,"Crawford County, Pennsylvania",1153,820,6,665,149,333,80098,67611,964,60860,5787,12487,83424,70206,971,63089,6146,13218
42041,"Cumberland County, Pennsylvania",6716,5923,3,5053,867,793,204454,187025,1371,175141,10513,17429,232624,213563,1374,199620,12569,19061
42043,"Dauphin County, Pennsylvania",48799,43403,811,36992,5600,5396,179909,162724,751,152458,9515,17185,266275,240922,1930,220246,18746,25353
42045,"Delaware County, Pennsylvania",114187,104244,271,91132,12841,9943,368761,345060,1731,328527,14802,23701,541594,504097,2039,471435,30623,37497
42047,"Elk County, Pennsylvania",131,131,0,131,0,0,29655,26184,326,24375,1483,3471,30378,26891,326,25024,1541,3487
42049,"Erie County, Pennsylvania",17631,15317,220,11789,3308,2314,225908,204458,1754,187977,14727,21450,264911,239542,2141,217285,20116,25369
42051,"Fayette County, Pennsylvania",4009,3306,0,2748,558,703,119412,99768,918,90655,8195,19644,128359,107617,1003,97393,9221,20742
42053,"Forest County, Pennsylvania",0,0,0,0,0,0,2834,2266,65,1894,307,568,2901,2322,65,1934,323,579
42055,"Franklin County, Pennsylvania",5458,4500,87,3668,745,958,134191,118256,1866,107203,9187,15935,150798,132026,1967,119502,10557,18772
42057,"Fulton County, Pennsylvania",215,182,0,110,72,33,14077,11942,222,10697,1023,2135,14593,12355,222,11015,1118,2238
42059,"Greene County, Pennsylvania",155,89,0,89,0,66,32967,28932,223,26065,2644,4035,33880,29724,223,26841,2660,4156
42061,"Huntingdon County, Pennsylvania",479,377,0,231,146,102,38860,33895,405,30157,3333,4965,40410,35276,420,31312,3544,5134
42063,"Indiana County, Pennsylvania",740,664,0,378,286,76,77455,64035,908,56826,6301,13420,80748,67034,964,59241,6829,13714
42065,"Jefferson County, Pennsylvania",168,151,0,84,67,17,42433,34733,411,31907,2415,7700,43489,35693,415,32599,2679,7796
42067,"Juniata County, Pennsylvania",238,209,0,201,8,29,22931,18373,311,16332,1730,4558,24156,19504,311,17319,1874,4652
42069,"Lackawanna County, Pennsylvania",5300,4830,2,3969,859,470,177060,156727,1360,143782,11585,20333,203755,181307,1379,165065,14863,22448
42071,"Lancaster County, Pennsylvania",21807,19151,92,15655,3404,2656,433470,369547,4005,334520,31022,63923,523846,451488,4303,404283,42902,72358
42073,"Lawrence County, Pennsylvania",2983,2586,0,2071,515,397,79224,68576,949,62061,5566,10648,85933,74665,968,67156,6541,11268
42075,"Lebanon County, Pennsylvania",2879,2614,0,2371,243,265,111834,99212,730,90105,8377,12622,134363,120009,794,108855,10360,14354
42077,"Lehigh County, Pennsylvania",23973,22164,27,19738,2399,1809,233032,212560,1818,198551,12191,20472,351658,321998,2236,294571,25191,29660
42079,"Luzerne County, Pennsylvania",10993,9768,113,8371,1284,1225,258464,225434,2582,204899,17953,33030,305856,269095,3165,241992,23938,36761
42081,"Lycoming County, Pennsylvania",4796,4338,0,3314,1024,458,100145,88471,1007,78835,8629,11674,109509,97172,1007,85994,10171,12337
42083,"McKean County, Pennsylvania",53,53,0,33,20,0,37762,33035,322,28744,3969,4727,39038,34180,322,29650,4208,4858
42085,"Mercer County, Pennsylvania",5298,4460,59,3480,921,838,97152,84303,886,76747,6670,12849,106298,92232,966,83185,8081,14066
42087,"Mifflin County, Pennsylvania",245,207,0,207,0,38,44080,35172,869,29512,4791,8908,45776,36699,869,30852,4978,9077
42089,"Monroe County, Pennsylvania",23261,22192,36,20559,1597,1069,111402,103428,837,95715,6876,7974,164991,155060,1045,143007,11008,9931
42091,"Montgomery County, Pennsylvania",68134,64346,216,59490,4640,3788,612705,582244,2236,561784,18224,30461,796540,757748,2663,726155,28930,38792
42093,"Montour County, Pennsylvania",177,177,10,129,38,0,16338,13745,201,12396,1148,2593,17561,14940,211,13541,1188,2621
42095,"Northampton County, Pennsylvania",15108,13438,0,12167,1271,1670,226811,208059,1852,194135,12072,18752,289924,265381,2126,244515,18740,24543
42097,"Northumberland County, Pennsylvania",933,810,7,641,162,123,84403,69839,907,61928,7004,14564,88820,73802,925,65480,7397,15018
42099,"Perry County, Pennsylvania",275,221,0,217,4,54,43598,37992,617,34039,3336,5606,45272,39546,636,35491,3419,5726
42101,"Philadelphia County, Pennsylvania",651524,547979,3012,448475,96492,103545,523445,470015,2724,431099,36192,53430,1520247,1328217,7443,1146772,174002,192030
42103,"Pike County, Pennsylvania",3300,3221,0,3145,76,79,44914,41919,349,39265,2305,2995,55272,51930,349,49049,2532,3342
42105,"Potter County, Pennsylvania",40,26,0,26,0,14,16286,13974,155,12577,1242,2312,16802,14430,162,13006,1262,2372
42107,"Schuylkill County, Pennsylvania",1207,1159,0,951,208,48,129161,112005,1280,101774,8951,17156,137154,119249,1316,107924,10009,17905
42109,"Snyder County, Pennsylvania",218,211,12,157,42,7,36768,30394,396,26849,3149,6374,38355,31858,410,28188,3260,6497
42111,"Somerset County, Pennsylvania",258,207,0,156,51,51,68806,57380,801,50497,6082,11426,70528,58936,822,51778,6336,11592
42113,"Sullivan County, Pennsylvania",0,0,0,0,0,0,5545,4650,129,4081,440,895,5734,4795,129,4214,452,939
42115,"Susquehanna County, Pennsylvania",234,212,0,190,22,22,39942,36242,408,32630,3204,3700,41403,37539,414,33749,3376,3864
42117,"Tioga County, Pennsylvania",147,139,0,82,57,8,39384,34908,656,31313,2939,4476,40776,36188,667,32386,3135,4588
42119,"Union County, Pennsylvania",321,301,0,261,40,20,33310,28364,240,25318,2806,4946,35636,30589,240,26868,3481,5047
42121,"Venango County, Pennsylvania",238,234,0,170,64,4,49920,43680,566,39222,3892,6240,51659,45220,569,40542,4109,6439
42123,"Warren County, Pennsylvania",158,158,11,121,26,0,38460,33495,592,29116,3787,4965,39621,34599,619,30032,3948,5022
42125,"Washington County, Pennsylvania",5587,4864,36,4428,400,723,187964,169758,1271,157902,10585,18206,202263,182858,1320,170089,11449,19405
42127,"Wayne County, Pennsylvania",380,380,0,345,35,0,45120,40544,877,36474,3193,4576,47733,43069,883,38894,3292,4664
42129,"Westmoreland County, Pennsylvania",7329,5655,13,4460,1182,1674,329415,293115,2751,269439,20925,36300,348681,309832,2799,283728,23305,38849
42131,"Wyoming County, Pennsylvania",32,31,0,29,2,1,26102,23569,287,22054,1228,2533,27036,24378,287,22852,1239,2658
42133,"York County, Pennsylvania",23564,21388,111,17864,3413,2176,366555,331251,3154,302830,25267,35304,433372,391764,3557,353370,34837,41608
44001,"Bristol County, Rhode Island",634,556,0,556,0,78,42160,39096,163,37210,1723,3064,45389,42107,163,40054,1890,3282
44003,"Kent County, Rhode Island",2366,2350,0,2152,198,16,145471,134803,301,128732,5770,10668,162554,151321,301,144148,6872,11233
44005,"Newport County, Rhode Island",2773,2389,60,2129,200,384,68424,64295,320,59769,4206,4129,79506,73816,431,68657,4728,5690
44007,"Providence County, Rhode Island",57980,50907,157,45606,5144,7073,376484,341261,1512,321346,18403,35223,607525,548529,2214,504483,41832,58996
44009,"Washington County, Rhode Island",1251,1081,0,1046,35,170,109976,103891,201,99542,4148,6085,119577,112726,201,107619,4906,6851
45001,"Abbeville County, South Carolina",6617,4860,99,3684,1077,1757,16492,14425,20,12568,1837,2067,23892,20063,119,16802,3142,3829
45003,"Aiken County, South Carolina",39842,33077,221,26041,6815,6765,108974,99119,873,87738,10508,9855,162971,144993,1169,125096,18728,17978
45005,"Allendale County, South Carolina",6269,4839,84,2926,1829,1430,1664,1312,3,1110,199,352,8209,6425,87,4236,2102,1784
45007,"Anderson County, South Carolina",31049,23981,15,18296,5670,7068,148692,132937,503,116998,15436,15755,191662,167838,518,144440,22880,23824
45009,"Bamberg County, South Carolina",8323,6688,274,4658,1756,1635,5008,4189,0,3597,592,819,13695,11221,274,8595,2352,2474
45011,"Barnwell County, South Carolina",9729,7245,39,4856,2350,2484,10996,9188,52,7941,1195,1808,21465,16890,91,13067,3732,4575
45013,"Beaufort County, South Carolina",32321,26497,163,19744,6590,5824,117449,113682,646,107509,5527,3767,173852,162421,1165,145805,15451,11431
45015,"Berkeley County, South Carolina",48737,41795,405,34344,7046,6942,128833,122972,604,111351,11017,5861,201138,186740,1052,164818,20870,14398
45017,"Calhoun County, South Carolina",6131,4424,0,3714,710,1707,7844,6678,67,5882,729,1166,14633,11736,67,10024,1645,2897
45019,"Charleston County, South Carolina",103735,85612,292,63899,21421,18123,241147,231741,517,208321,22903,9406,376069,344609,814,294185,49610,31460
45021,"Cherokee County, South Carolina",10944,7919,0,6132,1787,3025,40867,33498,337,28069,5092,7369,55723,44599,337,36895,7367,11124
45023,"Chester County, South Carolina",11735,8066,99,5073,2894,3669,19022,15804,270,12904,2630,3218,32248,25155,369,19019,5767,7093
45025,"Chesterfield County, South Carolina",14584,10494,59,7411,3024,4090,27655,23185,121,19268,3796,4470,45327,35993,180,28684,7129,9334
45027,"Clarendon County, South Carolina",15522,11287,117,8617,2553,4235,15664,13838,81,11944,1813,1826,32545,26254,206,21625,4423,6291
45029,"Colleton County, South Carolina",14146,11235,167,9681,1387,2911,20700,18994,162,17400,1432,1706,36941,31951,329,28752,2870,4990
45031,"Darlington County, South Carolina",27106,21093,145,16970,3978,6013,36381,31345,254,28200,2891,5036,66294,54951,399,47201,7351,11343
45033,"Dillon County, South Carolina",14516,10909,102,7290,3517,3607,14097,11175,47,8819,2309,2922,30643,23715,153,17031,6531,6928
45035,"Dorchester County, South Carolina",37883,32712,174,25920,6618,5171,97510,91029,281,83940,6808,6481,149864,137686,475,123080,14131,12178
45037,"Edgefield County, South Carolina",8515,5953,126,4536,1291,2562,14313,12652,240,10919,1493,1661,23787,19332,366,16078,2888,4455
45039,"Fairfield County, South Carolina",12425,9099,149,6256,2694,3326,8362,7085,29,5505,1551,1277,22504,17785,178,13275,4332,4719
45041,"Florence County, South Carolina",56583,45638,385,35064,10189,10945,71748,64111,208,57631,6272,7637,135228,116044,609,98182,17253,19184
45043,"Georgetown County, South Carolina",18972,15246,74,10247,4925,3726,38303,34620,99,31192,3329,3683,60453,52777,173,43968,8636,7676
45045,"Greenville County, South Carolina",86798,72733,427,58787,13519,14065,330209,303651,897,283402,19352,26558,478595,429457,1586,387596,40275,49138
45047,"Greenwood County, South Carolina",21300,17092,227,11360,5505,4208,40740,36562,221,32352,3989,4178,67619,58504,448,46817,11239,9115
45049,"Hampton County, South Carolina",9948,7259,142,5817,1300,2689,7889,6928,56,5996,876,961,18645,14934,198,12549,2187,3711
45051,"Horry County, South Carolina",41452,35428,243,28499,6686,6024,237058,222189,1102,203126,17961,14869,306688,281445,1384,251888,28173,25243
45053,"Jasper County, South Carolina",11709,8205,61,5178,2966,3504,11228,9968,123,9126,719,1260,26940,21298,184,16555,4559,5642
45055,"Kershaw County, South Carolina",15256,11660,200,7964,3496,3596,43827,39332,527,32166,6639,4495,63365,55116,727,43564,10825,8249
45057,"Lancaster County, South Carolina",17688,13630,40,10432,3158,4058,59956,53563,339,48690,4534,6393,84570,73342,448,64434,8460,11228
45059,"Laurens County, South Carolina",16109,12379,93,9095,3191,3730,43688,38190,311,32104,5775,5498,64099,54098,412,44134,9552,10001
45061,"Lee County, South Carolina",10411,7338,117,4944,2277,3073,5365,4665,147,3539,979,700,16246,12452,296,8732,3424,3794
45063,"Lexington County, South Carolina",39912,35323,53,28403,6867,4589,210970,196262,1185,178002,17075,14708,278609,255648,1303,226131,28214,22961
45065,"McCormick County, South Carolina",3774,2843,0,2284,559,931,4398,3945,20,3587,338,453,8427,6920,20,5981,919,1507
45067,"Marion County, South Carolina",17990,12497,164,7093,5240,5493,12188,10607,99,8100,2408,1581,31609,24040,269,15868,7903,7569
45069,"Marlboro County, South Carolina",11982,9068,19,6915,2134,2914,10249,8743,267,6824,1652,1506,24446,19598,301,15096,4201,4848
45071,"Newberry County, South Carolina",11499,8186,226,5908,2052,3313,22071,18303,212,15671,2420,3768,36725,28806,461,23230,5115,7919
45073,"Oconee County, South Carolina",5225,4375,0,3615,760,850,63848,56063,438,47635,7990,7785,75114,65477,470,55651,9356,9637
45075,"Orangeburg County, South Carolina",53024,40822,562,32807,7453,12202,29216,24859,250,21003,3606,4357,86426,68779,812,56523,11444,17647
45077,"Pickens County, South Carolina",7173,5920,18,5102,800,1253,99255,88119,622,77579,9918,11136,114940,102262,640,89644,11978,12678
45079,"Richland County, South Carolina",178025,160014,595,129388,30031,18011,159981,152922,429,142099,10394,7059,373681,347639,1226,301515,44898,26042
45081,"Saluda County, South Carolina",5126,2914,0,1912,1002,2212,11585,9478,139,8017,1322,2107,19873,14445,139,11613,2693,5428
45083,"Spartanburg County, South Carolina",58517,48701,109,40523,8069,9816,200399,182125,1099,164618,16408,18274,290164,260153,1221,231736,27196,30011
45085,"Sumter County, South Carolina",49173,40489,369,33543,6577,8684,48172,44083,485,39627,3971,4089,105014,91091,860,78926,11305,13923
45087,"Union County, South Carolina",8423,6191,28,4377,1786,2232,17773,14930,124,12452,2354,2843,27285,21900,152,17516,4232,5385
45089,"Williamsburg County, South Carolina",19929,14402,194,8942,5266,5527,9746,7566,52,6030,1484,2180,30427,22575,246,15404,6925,7852
45091,"York County, South Carolina",46544,41559,132,34712,6715,4985,176828,165673,573,152746,12354,11155,247756,230552,799,208196,21557,17204
46003,"Aurora County, South Dakota",37,4,0,4,0,33,2347,2032,15,1875,142,315,2581,2176,15,2012,149,405
46005,"Beadle County, South Dakota",54,54,0,54,0,0,13982,12470,129,11033,1308,1512,17482,15403,344,12642,2417,2079
46007,"Bennett County, South Dakota",8,8,0,8,0,0,1057,873,9,739,125,184,3400,2536,33,2065,438,864
46009,"Bon Homme County, South Dakota",6,6,0,6,0,0,5238,4610,40,4076,494,628,5557,4909,40,4353,516,648
46011,"Brookings County, South Dakota",405,395,0,389,6,10,27359,26175,122,23288,2765,1184,29967,28743,130,25562,3051,1224
46013,"Brown County, South Dakota",586,586,0,545,41,0,33072,29535,153,27612,1770,3537,37219,33085,161,30675,2249,4134
46015,"Brule County, South Dakota",0,0,0,0,0,0,4269,3292,16,2820,456,977,4999,3870,27,3374,469,1129
46017,"Buffalo County, South Dakota",8,8,0,5,3,0,238,224,0,206,18,14,2044,1365,11,1077,277,679
46019,"Butte County, South Dakota",60,60,0,60,0,0,9234,8435,23,7776,636,799,10061,9160,23,8489,648,901
46021,"Campbell County, South Dakota",0,0,0,0,0,0,1400,1183,4,1107,72,217,1439,1222,4,1146,72,217
46023,"Charles Mix County, South Dakota",4,4,0,4,0,0,5589,4682,41,4027,614,907,8969,6879,103,5591,1185,2090
46025,"Clark County, South Dakota",0,0,0,0,0,0,3383,2924,143,2394,387,459,3449,2985,143,2455,387,464
46027,"Clay County, South Dakota",159,159,0,129,30,0,10296,9839,6,9156,677,457,11662,11186,6,10439,741,476
46029,"Codington County, South Dakota",137,129,0,96,33,8,25535,23455,306,20374,2775,2080,27372,25209,308,21870,3031,2163
46031,"Corson County, South Dakota",19,19,0,19,0,0,1223,1020,8,934,78,203,4172,2492,8,2113,371,1680
46033,"Custer County, South Dakota",0,0,0,0,0,0,7444,6800,206,5936,658,644,8075,7319,222,6286,811,756
46035,"Davison County, South Dakota",102,102,0,102,0,0,17287,15646,38,14783,825,1641,18774,16765,38,15826,901,2009
46037,"Day County, South Dakota",0,0,0,0,0,0,4629,3986,69,3364,553,643,5364,4570,69,3695,806,794
46039,"Deuel County, South Dakota",0,0,0,0,0,0,4080,3641,193,3064,384,439,4216,3748,193,3171,384,468
46041,"Dewey County, South Dakota",7,7,0,7,0,0,1128,883,5,813,65,245,5645,3624,5,3094,525,2021
46043,"Douglas County, South Dakota",0,0,0,0,0,0,2692,2293,9,1999,285,399,2836,2407,9,2110,288,429
46045,"Edmunds County, South Dakota",2,2,0,2,0,0,3696,3325,6,2927,392,371,3788,3411,6,3003,402,377
46047,"Fall River County, South Dakota",47,47,0,27,20,0,5483,4862,69,4518,275,621,6471,5786,69,5380,337,685
46049,"Faulk County, South Dakota",1,1,0,1,0,0,1988,1644,12,1506,126,344,2000,1656,12,1518,126,344
46051,"Grant County, South Dakota",0,0,0,0,0,0,6628,5972,95,5364,513,656,7001,6339,96,5711,532,662
46053,"Gregory County, South Dakota",0,0,0,0,0,0,3672,3058,17,2614,427,614,4162,3433,17,2908,508,729
46055,"Haakon County, South Dakota",0,0,0,0,0,0,1813,1462,11,1132,319,351,2047,1696,11,1355,330,351
46057,"Hamlin County, South Dakota",10,4,0,4,0,6,5414,5086,66,4096,924,328,5700,5357,66,4239,1052,343
46059,"Hand County, South Dakota",1,1,0,1,0,0,3176,2792,9,2534,249,384,3245,2861,9,2581,271,384
46061,"Hanson County, South Dakota",124,5,0,5,0,119,3196,3024,37,2852,135,172,3337,3046,37,2874,135,291
46063,"Harding County, South Dakota",0,0,0,0,0,0,1166,1084,1,1012,71,82,1205,1123,1,1051,71,82
46065,"Hughes County, South Dakota",79,44,0,44,0,35,13996,12770,27,11969,774,1226,16356,14643,27,13692,924,1713
46067,"Hutchinson County, South Dakota",0,0,0,0,0,0,6672,5659,71,4813,775,1013,6859,5831,71,4985,775,1028
46069,"Hyde County, South Dakota",0,0,0,0,0,0,1136,983,0,928,55,153,1334,1121,0,1050,71,213
46071,"Jackson County, South Dakota",0,0,0,0,0,0,1306,1114,7,921,186,192,3144,2010,7,1364,639,1134
46073,"Jerauld County, South Dakota",0,0,0,0,0,0,1919,1667,66,1414,187,252,1992,1730,66,1471,193,262
46075,"Jones County, South Dakota",0,0,0,0,0,0,740,676,10,600,66,64,740,676,10,600,66,64
46077,"Kingsbury County, South Dakota",0,0,0,0,0,0,4675,4111,34,3536,541,564,4914,4333,34,3702,597,581
46079,"Lake County, South Dakota",37,37,0,37,0,0,10953,10062,28,9034,1000,891,11635,10744,28,9352,1364,891
46081,"Lawrence County, South Dakota",156,156,0,156,0,0,21955,20253,69,18946,1238,1702,23676,21807,76,20258,1473,1869
46083,"Lincoln County, South Dakota",562,562,0,562,0,0,49323,47577,652,44733,2192,1746,52642,50851,799,47730,2322,1791
46085,"Lyman County, South Dakota",2,0,0,0,0,2,2172,1948,4,1646,298,224,3841,3253,4,2690,559,588
46087,"McCook County, South Dakota",16,16,0,12,4,0,4995,4615,42,4020,553,380,5257,4853,43,4194,616,404
46089,"McPherson County, South Dakota",3,3,0,3,0,0,1980,1583,6,1402,175,397,2068,1671,6,1438,227,397
46091,"Marshall County, South Dakota",22,22,0,22,0,0,3865,3550,77,3142,331,315,4620,4166,77,3560,529,454
46093,"Meade County, South Dakota",432,432,0,401,31,0,23251,21355,151,19571,1633,1896,26273,24278,218,22099,1961,1995
46095,"Mellette County, South Dakota",0,0,0,0,0,0,838,637,6,494,137,201,2026,1367,6,817,544,659
46097,"Miner County, South Dakota",20,20,0,20,0,0,2109,1873,26,1698,149,236,2212,1975,26,1778,171,237
46099,"Minnehaha County, South Dakota",8546,7450,177,5630,1643,1096,149185,139959,1020,128687,10252,9226,177861,165643,1364,149961,14318,12218
46101,"Moody County, South Dakota",9,9,0,4,5,0,4744,4280,30,3810,440,464,6128,5493,30,4830,633,635
46102,"Oglala Lakota County, South Dakota",10,10,0,10,0,0,330,236,0,225,11,94,13987,8328,61,6569,1698,5659
46103,"Pennington County, South Dakota",1162,1063,0,904,159,99,84729,78766,461,72115,6190,5963,104502,96830,520,87708,8602,7672
46105,"Perkins County, South Dakota",3,3,0,3,0,0,2706,2265,21,2104,140,441,2860,2387,21,2221,145,473
46107,"Potter County, South Dakota",0,0,0,0,0,0,2073,1836,48,1650,138,237,2234,1997,48,1804,145,237
46109,"Roberts County, South Dakota",49,49,0,29,20,0,5734,4977,121,4350,506,757,10029,8134,154,6783,1197,1895
46111,"Sanborn County, South Dakota",0,0,0,0,0,0,2210,1981,19,1830,132,229,2319,2082,19,1923,140,237
46115,"Spink County, South Dakota",8,8,0,8,0,0,6019,5403,24,4962,417,616,6287,5633,24,5146,463,654
46117,"Stanley County, South Dakota",0,0,0,0,0,0,2628,2385,0,2329,56,243,2994,2601,0,2545,56,393
46119,"Sully County, South Dakota",0,0,0,0,0,0,1319,1172,2,1060,110,147,1382,1225,2,1113,110,157
46121,"Todd County, South Dakota",32,32,0,25,7,0,845,744,16,584,144,101,9980,6657,22,5025,1610,3323
46123,"Tripp County, South Dakota",0,0,0,0,0,0,4385,3900,15,3474,411,485,5321,4729,15,4058,656,592
46125,"Turner County, South Dakota",28,28,0,28,0,0,7715,6709,67,5827,815,1006,8052,6986,67,6046,873,1066
46127,"Union County, South Dakota",99,99,0,99,0,0,13774,12689,97,11433,1159,1085,14818,13679,100,12354,1225,1139
46129,"Walworth County, South Dakota",24,24,0,0,24,0,4143,3461,15,3035,411,682,5193,4211,15,3721,475,982
46135,"Yankton County, South Dakota",242,168,0,168,0,74,19081,17173,158,15117,1898,1908,20844,18656,158,16365,2133,2188
46137,"Ziebach County, South Dakota",1,0,0,0,0,1,664,512,1,482,29,152,2837,1580,6,1315,259,1257
47001,"Anderson County, Tennessee",2440,2016,0,1703,313,424,66672,57287,396,51266,5625,9385,74362,64077,414,57418,6245,10285
47003,"Bedford County, Tennessee",3013,2383,0,2085,298,630,36068,32376,173,26621,5582,3692,46293,41461,206,33948,7307,4832
47005,"Benton County, Tennessee",547,399,0,399,0,148,14882,12274,224,9697,2353,2608,15970,13179,224,10587,2368,2791
47007,"Bledsoe County, Tennessee",310,155,0,155,0,155,12107,9671,62,7866,1743,2436,13235,10342,62,8480,1800,2893
47009,"Blount County, Tennessee",3013,2658,24,2294,340,355,114590,103525,508,91719,11298,11065,125150,113038,603,100098,12337,12112
47011,"Bradley County, Tennessee",4986,3808,63,3171,574,1178,87103,76462,441,67612,8409,10641,100652,87609,535,77256,9818,13043
47013,"Campbell County, Tennessee",195,143,0,143,0,52,37976,28819,238,23443,5138,9157,39276,29887,238,24357,5292,9389
47015,"Cannon County, Tennessee",180,94,0,84,10,86,12916,11247,165,8624,2458,1669,13655,11828,167,9133,2528,1827
47017,"Carroll County, Tennessee",2517,1798,0,1558,240,719,23221,19471,108,17411,1952,3750,27205,22560,108,19891,2561,4645
47019,"Carter County, Tennessee",648,475,102,233,140,173,52295,42028,1140,34368,6520,10267,54830,44213,1242,36115,6856,10617
47021,"Cheatham County, Tennessee",471,403,0,337,66,68,36817,33427,326,29864,3237,3390,39384,35707,326,31792,3589,3677
47023,"Chester County, Tennessee",1532,1321,0,1187,134,211,13640,11619,150,10287,1182,2021,15877,13645,150,11994,1501,2232
47025,"Claiborne County, Tennessee",136,94,0,86,8,42,29303,22708,419,18966,3323,6595,30313,23559,419,19716,3424,6754
47027,"Clay County, Tennessee",139,124,0,89,35,15,7204,5110,121,4037,952,2094,7576,5431,154,4278,999,2145
47029,"Cocke County, Tennessee",714,612,0,399,213,102,32703,25424,260,18658,6506,7279,34929,27430,277,19936,7217,7499
47031,"Coffee County, Tennessee",1055,915,0,755,160,140,47776,42352,150,35532,6670,5424,53386,47243,150,38578,8515,6143
47033,"Crockett County, Tennessee",1870,1409,0,1162,247,461,10715,8996,46,7316,1634,1719,14340,11794,46,9713,2035,2546
47035,"Cumberland County, Tennessee",304,304,0,304,0,0,54439,47166,500,40410,6256,7273,57416,49582,515,42463,6604,7834
47037,"Davidson County, Tennessee",178712,156641,342,127340,28959,22071,370391,348481,1285,321149,26047,21910,656836,605127,1739,534224,69164,51709
47039,"Decatur County, Tennessee",317,232,9,186,37,85,10504,9010,112,7559,1339,1494,11453,9810,121,8171,1518,1643
47041,"DeKalb County, Tennessee",205,173,0,138,35,32,16979,13699,153,12070,1476,3280,19064,15160,153,13414,1593,3904
47043,"Dickson County, Tennessee",1889,1143,0,978,165,746,45580,38148,383,33290,4475,7432,50622,42062,383,36881,4798,8560
47045,"Dyer County, Tennessee",4997,4399,0,3533,866,598,29896,25944,162,23457,2325,3952,37194,32421,162,28746,3513,4773
47047,"Fayette County, Tennessee",10658,7838,54,5657,2127,2820,26601,24601,132,22139,2330,2000,38809,33866,199,29078,4589,4943
47049,"Fentress County, Tennessee",0,0,0,0,0,0,17216,14169,165,12051,1953,3047,17768,14632,165,12447,2020,3136
47051,"Franklin County, Tennessee",1893,1610,0,1294,316,283,35227,30763,315,25253,5195,4464,39479,34062,315,27763,5984,5417
47053,"Gibson County, Tennessee",8489,6271,0,4915,1356,2218,36899,32354,340,27160,4854,4545,48071,41055,340,34222,6493,7016
47055,"Giles County, Tennessee",2705,2113,49,1532,532,592,24027,21004,219,16482,4303,3023,28224,24560,268,19194,5098,3664
47057,"Grainger County, Tennessee",80,39,0,0,39,41,21623,18223,221,15828,2174,3400,22790,19140,249,16345,2546,3650
47059,"Greene County, Tennessee",1364,1211,56,679,476,153,62325,51783,743,44476,6564,10542,66538,55423,799,47132,7492,11115
47061,"Grundy County, Tennessee",42,42,0,42,0,0,10687,8283,159,7080,1044,2404,13171,10002,159,8581,1262,3169
47063,"Hamblen County, Tennessee",2458,1923,0,1653,270,535,51237,43685,138,37748,5799,7552,62619,52946,145,45430,7371,9673
47065,"Hamilton County, Tennessee",66905,52551,166,43163,9222,14354,245024,224191,568,207745,15878,20833,343292,303974,734,273915,29325,39318
47067,"Hancock County, Tennessee",0,0,0,0,0,0,6272,4474,54,3035,1385,1798,6430,4591,54,3081,1456,1839
47069,"Hardeman County, Tennessee",8700,5920,10,4028,1882,2780,12366,10121,187,7717,2217,2245,21875,16685,197,12320,4168,5190
47071,"Hardin County, Tennessee",930,787,0,695,92,143,23314,19702,288,15884,3530,3612,25346,21375,307,17406,3662,3971
47073,"Hawkins County, Tennessee",675,570,0,432,138,105,53239,44265,932,34607,8726,8974,55784,46610,943,36241,9426,9174
47075,"Haywood County, Tennessee",8841,6456,80,4771,1605,2385,7884,6443,64,5409,970,1441,17714,13819,144,10977,2698,3895
47077,"Henderson County, Tennessee",2143,1494,0,1017,477,649,24194,21115,259,18272,2584,3079,27552,23315,259,19748,3308,4237
47079,"Henry County, Tennessee",2790,2161,21,1457,683,629,27847,24093,30,20604,3459,3754,31754,27201,54,22917,4230,4553
47081,"Hickman County, Tennessee",396,327,0,291,36,69,21541,16600,141,13759,2700,4941,22952,17851,158,14740,2953,5101
47083,"Houston County, Tennessee",311,237,0,229,8,74,7348,5965,112,5176,677,1383,7965,6403,112,5594,697,1562
47085,"Humphreys County, Tennessee",639,594,0,594,0,45,16814,13968,124,11929,1915,2846,18052,15113,124,13058,1931,2939
47087,"Jackson County, Tennessee",41,41,0,41,0,0,10928,7925,98,7130,697,3003,11369,8285,102,7381,802,3084
47089,"Jefferson County, Tennessee",675,624,0,356,268,51,47415,42155,59,35164,6932,5260,51018,45358,59,37920,7379,5660
47091,"Johnson County, Tennessee",151,151,0,151,0,0,15280,11330,410,8941,1979,3950,15904,11815,433,9250,2132,4089
47093,"Knox County, Tennessee",38708,31444,11,24631,6802,7264,365013,339687,1154,312613,25920,25326,440845,405161,1172,365795,38194,35684
47095,"Lake County, Tennessee",955,593,0,524,69,362,3766,3043,27,2648,368,723,4868,3755,31,3277,447,1113
47097,"Lauderdale County, Tennessee",7517,5780,4,4252,1524,1737,14821,12504,67,10681,1756,2317,23630,19303,87,15667,3549,4327
47099,"Lawrence County, Tennessee",753,630,0,525,105,123,39636,31324,186,26399,4739,8312,42124,33497,200,28217,5080,8627
47101,"Lewis County, Tennessee",105,86,0,77,9,19,10979,8813,107,6791,1915,2166,11703,9352,107,7294,1951,2351
47103,"Lincoln County, Tennessee",2232,1545,0,1050,495,687,29050,24830,195,20020,4615,4220,33173,28123,195,22579,5349,5050
47105,"Loudon County, Tennessee",617,517,0,465,52,100,44740,40721,234,35338,5149,4019,50599,45444,255,38769,6420,5155
47107,"McMinn County, Tennessee",1773,1356,45,1131,180,417,46185,37999,657,32482,4860,8186,51432,42417,716,36504,5197,9015
47109,"McNairy County, Tennessee",1431,1079,0,809,270,352,23110,19369,266,15413,3690,3741,25609,21488,266,17195,4027,4121
47111,"Macon County, Tennessee",62,62,0,43,19,0,21112,17058,163,14499,2396,4054,22887,18210,163,15547,2500,4677
47113,"Madison County, Tennessee",34732,28057,141,21187,6729,6675,53327,48715,195,43793,4727,4612,94016,82078,343,69823,11912,11938
47115,"Marion County, Tennessee",457,388,0,360,28,69,25925,21500,81,18241,3178,4425,28058,23328,81,19636,3611,4730
47117,"Marshall County, Tennessee",2312,1931,0,1770,161,381,26795,23772,214,19623,3935,3023,31321,27668,214,23004,4450,3653
47119,"Maury County, Tennessee",9915,8727,0,7271,1456,1188,68908,63532,529,57508,5495,5376,86346,79357,628,70406,8323,6989
47121,"Meigs County, Tennessee",140,117,0,117,0,23,11075,9011,79,7417,1515,2064,11708,9587,79,7966,1542,2121
47123,"Monroe County, Tennessee",803,640,0,576,64,163,41211,34033,233,29838,3962,7178,45141,37265,242,32605,4418,7876
47125,"Montgomery County, Tennessee",36603,33122,36,28987,4099,3481,122167,114823,815,105315,8693,7344,188624,176295,974,160165,15156,12329
47127,"Moore County, Tennessee",96,96,0,50,46,0,5815,4827,141,3634,1052,988,6221,5214,141,3975,1098,1007
47129,"Morgan County, Tennessee",6,6,0,3,3,0,18550,15296,159,13235,1902,3254,18777,15503,159,13378,1966,3274
47131,"Obion County, Tennessee",3070,2311,16,1779,516,759,25215,21917,192,19269,2456,3298,30173,25640,208,21834,3598,4533
47133,"Overton County, Tennessee",98,98,0,98,0,0,20950,16172,301,14242,1629,4778,21697,16882,301,14905,1676,4815
47135,"Perry County, Tennessee",232,136,0,113,23,96,7179,4884,203,4205,476,2295,7736,5202,203,4455,544,2534
47137,"Pickett County, Tennessee",29,0,0,0,0,29,4834,3832,27,3587,218,1002,4983,3852,27,3599,226,1131
47139,"Polk County, Tennessee",14,9,0,9,0,5,15742,13029,126,10755,2148,2713,16475,13663,126,11263,2274,2812
47141,"Putnam County, Tennessee",1446,1085,30,1005,50,361,64293,54072,328,47891,5853,10221,72394,60034,503,52778,6753,12360
47143,"Rhea County, Tennessee",572,543,0,461,82,29,28807,23815,134,19630,4051,4992,31536,26018,134,21149,4735,5518
47145,"Roane County, Tennessee",1184,981,0,684,297,203,48633,42084,137,36603,5344,6549,52210,45197,137,39214,5846,7013
47147,"Robertson County, Tennessee",4606,3620,3,3252,365,986,57002,51718,393,46674,4651,5284,67637,60874,396,54765,5713,6763
47149,"Rutherford County, Tennessee",40340,37585,0,30277,7308,2755,213675,202966,645,184152,18169,10709,293634,278255,1052,245103,32100,15379
47151,"Scott County, Tennessee",3,3,0,3,0,0,21188,17145,150,14805,2190,4043,21591,17452,150,15049,2253,4139
47153,"Sequatchie County, Tennessee",13,13,0,0,13,0,12398,11021,194,9321,1506,1377,14423,12784,194,10791,1799,1639
47155,"Sevier County, Tennessee",552,545,0,514,31,7,85771,75579,442,66473,8664,10192,94488,83278,463,72759,10056,11210
47157,"Shelby County, Tennessee",489880,391612,1575,312242,77795,98268,335811,314520,1575,294129,18816,21291,920276,788524,3357,673914,111253,131752
47159,"Smith County, Tennessee",386,295,0,236,59,91,17777,14927,199,13192,1536,2850,19053,16066,209,14185,1672,2987
47161,"Stewart County, Tennessee",143,105,0,105,0,38,12066,9885,41,8218,1626,2181,13119,10780,41,8980,1759,2339
47163,"Sullivan County, Tennessee",2669,2422,0,2018,404,247,144500,127501,537,115418,11546,16999,153911,136204,549,122440,13215,17707
47165,"Sumner County, Tennessee",11901,10775,0,9434,1341,1126,148585,137199,616,127419,9164,11386,174288,161072,659,148619,11794,13216
47167,"Tipton County, Tennessee",10806,8578,127,6194,2257,2228,46362,42586,356,38180,4050,3776,60790,54356,483,47253,6620,6434
47169,"Trousdale County, Tennessee",959,666,0,563,103,293,7367,5559,74,4498,987,1808,8655,6554,74,5338,1142,2101
47171,"Unicoi County, Tennessee",19,0,0,0,0,19,16334,13680,184,11534,1962,2654,17300,14373,392,11889,2092,2927
47173,"Union County, Tennessee",49,26,0,0,26,23,18377,14949,186,11150,3613,3428,18998,15525,199,11604,3722,3473
47175,"Van Buren County, Tennessee",9,9,0,9,0,0,5370,4183,81,3863,239,1187,5573,4324,81,3997,246,1249
47177,"Warren County, Tennessee",404,271,0,230,41,133,34167,28493,223,25904,2366,5674,39550,32436,321,29270,2845,7114
47179,"Washington County, Tennessee",4325,3863,0,3425,438,462,108981,98690,757,90657,7276,10291,121498,110339,774,101044,8521,11159
47181,"Wayne County, Tennessee",128,122,0,122,0,6,13958,10617,296,9049,1272,3341,14690,11311,296,9725,1290,3379
47183,"Weakley County, Tennessee",2324,1959,0,1534,425,365,27470,23655,200,20140,3315,3815,31114,26696,209,22611,3876,4418
47185,"White County, Tennessee",349,142,0,142,0,207,24454,19579,89,17150,2340,4875,25987,20823,97,18340,2386,5164
47187,"Williamson County, Tennessee",8868,8175,24,7426,725,693,180664,175520,335,168979,6206,5144,211700,205148,359,196550,8239,6552
47189,"Wilson County, Tennessee",8492,7401,0,6478,923,1091,109661,102676,395,95935,6346,6985,127330,118522,418,110053,8051,8808
48001,"Anderson County, Texas",6628,4703,0,3738,965,1925,29615,25748,190,21266,4292,3867,44335,36914,201,29866,6847,7421
48003,"Andrews County, Texas",355,150,0,119,31,205,7152,6780,27,6327,426,372,17478,16204,89,15218,897,1274
48005,"Angelina County, Texas",12398,10944,70,9148,1726,1454,51775,47647,439,43189,4019,4128,84590,77404,513,69246,7645,7186
48007,"Aransas County, Texas",364,222,0,217,5,142,16522,15465,268,13735,1462,1057,24392,22096,334,19536,2226,2296
48009,"Archer County, Texas",99,99,0,99,0,0,7733,7114,48,5940,1126,619,8716,7969,48,6605,1316,747
48011,"Armstrong County, Texas",34,34,0,34,0,0,1616,1452,28,1193,231,164,1861,1642,28,1365,249,219
48013,"Atascosa County, Texas",341,187,0,174,13,154,16222,15036,62,13684,1290,1186,47701,43131,129,38161,4841,4570
48015,"Austin County, Texas",2562,2035,0,1822,213,527,18351,16650,179,15007,1464,1701,29010,25596,206,21785,3605,3414
48017,"Bailey County, Texas",79,15,0,15,0,64,2406,2296,52,2027,217,110,6920,5919,172,4007,1740,1001
48019,"Bandera County, Texas",41,12,0,12,0,29,16511,14555,208,12571,1776,1956,20770,18417,268,15761,2388,2353
48021,"Bastrop County, Texas",6151,5054,0,4145,909,1097,42228,39012,154,35040,3818,3216,78055,71217,234,62322,8661,6838
48023,"Baylor County, Texas",121,121,0,121,0,0,2958,2684,0,2297,387,274,3526,3200,0,2806,394,326
48025,"Bee County, Texas",442,273,0,227,46,169,8606,7845,54,6428,1363,761,24991,21995,78,16643,5274,2996
48027,"Bell County, Texas",74358,67403,176,58324,8903,6955,153278,144429,700,129333,14396,8849,326630,302442,1187,267022,34233,24188
48029,"Bexar County, Texas",138380,125913,443,105771,19699,12467,526265,500308,1842,464446,34020,25957,1860058,1685288,5232,1477277,202779,174770
48031,"Blanco County, Texas",75,0,0,0,0,75,8496,7963,154,7123,686,533,10972,9940,154,8744,1042,1032
48033,"Borden County, Texas",0,0,0,0,0,0,556,523,0,477,46,33,602,569,0,508,61,33
48035,"Bosque County, Texas",227,137,0,101,36,90,13811,12412,223,10305,1884,1399,17573,15452,315,12672,2465,2121
48037,"Bowie County, Texas",20992,15639,34,13003,2602,5353,58323,49868,783,43819,5266,8455,88206,72432,848,62667,8917,15774
48039,"Brazoria County, Texas",41960,40432,313,36108,4011,1528,165585,157533,816,144209,12508,8052,334691,312924,1295,280699,30930,21767
48041,"Brazos County, Texas",20592,17692,0,14160,3532,2900,112543,108906,142,96582,12182,3637,198708,186523,269,161435,24819,12185
48043,"Brewster County, Texas",6,6,0,6,0,0,4707,4270,39,3798,433,437,9110,7932,39,6772,1121,1178
48045,"Briscoe County, Texas",27,21,5,16,0,6,964,833,35,748,50,131,1591,1295,41,1169,85,296
48047,"Brooks County, Texas",61,61,0,61,0,0,405,234,0,234,0,171,6698,5410,30,4467,913,1288
48049,"Brown County, Texas",1284,996,0,736,260,288,26445,22995,165,20170,2660,3450,36045,30535,194,26954,3387,5510
48051,"Burleson County, Texas",2168,1334,9,1090,235,834,11415,9579,100,8536,943,1836,17413,13973,194,12033,1746,3440
48053,"Burnet County, Texas",647,437,0,388,49,210,32984,30432,180,26413,3839,2552,44515,40446,182,32955,7309,4069
48055,"Caldwell County, Texas",1598,1415,0,938,477,183,15402,13873,83,11122,2668,1529,36765,32406,381,23753,8272,4359
48057,"Calhoun County, Texas",538,433,7,405,21,105,9264,8730,18,7946,766,534,21539,19709,25,16894,2790,1830
48059,"Callahan County, Texas",195,195,0,187,8,0,11798,9467,342,7986,1139,2331,13575,10895,386,9308,1201,2680
48061,"Cameron County, Texas",1656,1448,0,1358,90,208,38774,34555,295,29856,4404,4219,416394,327171,1212,231291,94668,89223
48063,"Camp County, Texas",2105,1450,0,1195,255,655,7135,6173,112,4710,1351,962,12595,10400,112,7788,2500,2195
48065,"Carson County, Texas",36,18,0,10,8,18,5176,4760,44,4149,567,416,5976,5462,44,4734,684,514
48067,"Cass County, Texas",5091,3237,14,1959,1264,1854,22722,17927,475,14822,2630,4795,29675,22689,489,18216,3984,6986
48069,"Castro County, Texas",51,50,0,48,2,1,2544,2284,178,1936,170,260,7798,6674,178,5262,1234,1124
48071,"Chambers County, Texas",3110,2650,0,2642,8,460,26562,24186,207,22233,1746,2376,39007,34842,212,32116,2514,4165
48073,"Cherokee County, Texas",6032,4554,10,3472,1072,1478,30302,26703,325,23719,2659,3599,48727,41612,349,34054,7209,7115
48075,"Childress County, Texas",139,87,0,87,0,52,4044,3500,11,3290,199,544,5745,4950,34,4389,527,795
48077,"Clay County, Texas",44,44,0,44,0,0,9351,8200,21,6495,1684,1151,10301,8997,21,7070,1906,1304
48079,"Cochran County, Texas",61,42,0,31,11,19,1051,783,24,707,52,268,2814,2156,30,1750,376,658
48081,"Coke County, Texas",0,0,0,0,0,0,2442,2136,2,1841,293,306,3125,2778,2,2302,474,347
48083,"Coleman County, Texas",230,85,0,74,11,145,6466,5673,146,4808,719,793,8365,7032,198,5733,1101,1333
48085,"Collin County, Texas",84868,82082,126,74573,7383,2786,538390,527519,1104,504310,22105,10871,910891,890571,1534,833587,55450,20320
48087,"Collingsworth County, Texas",100,67,0,29,38,33,1777,1622,10,1405,207,155,2958,2549,10,2203,336,409
48089,"Colorado County, Texas",2719,2089,0,1533,556,630,11644,10109,97,8308,1704,1535,20556,17463,111,13936,3416,3093
48091,"Comal County, Texas",2490,2338,0,2085,253,152,87931,84058,119,79762,4177,3873,127971,119564,179,112078,7307,8407
48093,"Comanche County, Texas",130,100,0,100,0,30,9343,7903,299,6436,1168,1440,13274,10864,327,8223,2314,2410
48095,"Concho County, Texas",16,16,0,0,16,0,1666,1375,2,1309,64,291,2587,1986,2,1904,80,601
48097,"Cooke County, Texas",864,637,0,456,181,227,29435,26431,32,23382,3017,3004,38380,34296,41,28982,5273,4084
48099,"Coryell County, Texas",7247,6943,0,6477,466,304,39500,37248,152,34197,2899,2252,61431,57995,179,53561,4255,3436
48101,"Cottle County, Texas",153,67,0,67,0,86,803,725,10,623,92,78,1498,1235,10,1048,177,263
48103,"Crane County, Texas",205,205,0,151,54,0,1535,1458,13,1150,295,77,4732,4446,13,3449,984,286
48105,"Crockett County, Texas",20,20,0,20,0,0,1234,1014,0,980,34,220,3757,3205,0,2585,620,552
48107,"Crosby County, Texas",241,215,0,113,102,26,2288,2067,73,1680,314,221,5809,4927,77,3769,1081,882
48109,"Culberson County, Texas",0,0,0,0,0,0,376,356,6,320,30,20,2222,1716,88,1171,457,506
48111,"Dallam County, Texas",123,109,0,59,50,14,3672,3393,0,2612,781,279,7163,6137,0,4623,1514,1026
48113,"Dallas County, Texas",561903,477446,1633,398557,77256,84457,756924,716443,2185,670368,43890,40481,2521069,2242890,8109,1949269,285512,278179
48115,"Dawson County, Texas",156,86,0,46,40,70,4461,3917,70,3414,433,544,11310,9592,223,7406,1963,1718
48117,"Deaf Smith County, Texas",178,178,0,146,32,0,4789,4178,27,3757,394,611,18597,15779,37,13809,1933,2818
48119,"Delta County, Texas",401,259,0,164,95,142,4155,3643,36,3022,585,512,5099,4350,76,3519,755,749
48121,"Denton County, Texas",70088,68378,54,61376,6948,1710,469170,459048,1103,437927,20018,10122,768792,745993,1701,694396,49896,22799
48123,"DeWitt County, Texas",1532,959,0,715,244,573,10668,8997,85,7986,926,1671,18607,14370,87,12035,2248,4237
48125,"Dickens County, Texas",55,45,0,15,30,10,1461,1263,12,1140,111,198,2077,1800,12,1594,194,277
48127,"Dimmit County, Texas",0,0,0,0,0,0,1401,1099,0,1067,32,302,10697,8442,114,7181,1147,2255
48129,"Donley County, Texas",98,83,0,83,0,15,2621,2120,14,1703,403,501,3126,2567,18,2025,524,559
48131,"Duval County, Texas",45,45,0,45,0,0,924,723,0,667,56,201,10930,8018,76,6785,1157,2912
48133,"Eastland County, Texas",163,58,0,0,58,105,14100,11395,264,9820,1311,2705,17288,13903,264,11740,1899,3385
48135,"Ector County, Texas",6566,5542,0,5351,191,1024,52745,48619,60,46128,2431,4126,154014,141265,378,130916,9971,12749
48137,"Edwards County, Texas",0,0,0,0,0,0,906,806,5,631,170,100,2100,1554,5,1204,345,546
48139,"Ellis County, Texas",14972,13288,294,11026,1968,1684,101632,96437,471,88821,7145,5195,162288,151874,1185,134144,16545,10414
48141,"El Paso County, Texas",26124,24507,57,21810,2640,1617,99601,92799,703,86938,5158,6802,819587,718289,3592,624559,90138,101298
48143,"Erath County, Texas",396,396,0,230,166,0,29651,27341,101,22613,4627,2310,39003,35829,101,27875,7853,3174
48145,"Falls County, Texas",3686,2531,0,1402,1129,1155,8336,7051,104,5661,1286,1285,15534,12312,117,9322,2873,3222
48147,"Fannin County, Texas",1385,951,0,615,336,434,25323,22858,336,19538,2984,2465,30703,27239,345,23030,3864,3464
48149,"Fayette County, Texas",1443,916,99,509,308,527,17554,14776,489,12267,2020,2778,24438,19406,595,15658,3153,5032
48151,"Fisher County, Texas",108,39,0,22,17,69,2545,2260,28,2019,213,285,3836,3244,28,2720,496,592
48153,"Floyd County, Texas",162,141,0,76,65,21,2222,1941,14,1896,31,281,5908,5017,49,4400,568,891
48155,"Foard County, Texas",31,24,0,0,24,7,1043,954,7,816,131,89,1377,1227,7,1017,203,150
48157,"Fort Bend County, Texas",144927,140125,944,134824,4357,4802,242133,237144,498,229260,7386,4989,705630,686368,1980,652943,31445,19262
48159,"Franklin County, Texas",478,361,0,361,0,117,8399,7529,33,6569,927,870,10540,9390,45,8264,1081,1150
48161,"Freestone County, Texas",2763,2117,25,1542,550,646,12450,10975,137,9824,1014,1475,18004,15589,162,13240,2187,2415
48163,"Frio County, Texas",119,119,0,119,0,0,2766,2427,19,2087,321,339,15925,12277,66,9943,2268,3648
48165,"Gaines County, Texas",463,444,0,351,93,19,11120,10084,59,8204,1821,1036,19769,17530,103,14373,3054,2239
48167,"Galveston County, Texas",39589,33092,49,27663,5380,6497,182988,173092,725,160995,11372,9896,314880,290736,954,263778,26004,24144
48169,"Garza County, Texas",278,278,0,278,0,0,2585,2347,0,2190,157,238,4781,4129,0,3724,405,652
48171,"Gillespie County, Texas",32,32,0,32,0,0,19277,17378,112,15920,1346,1899,25554,22727,112,20545,2070,2827
48173,"Glasscock County, Texas",0,0,0,0,0,0,844,814,13,743,58,30,1420,1302,13,1005,284,118
48175,"Goliad County, Texas",379,304,0,286,18,75,4364,3903,71,3084,748,461,7408,6204,71,4862,1271,1204
48177,"Gonzales County, Texas",1360,973,0,890,83,387,8530,7546,123,6901,522,984,20235,16588,146,14548,1894,3647
48179,"Gray County, Texas",524,340,0,305,35,184,14190,12607,89,10996,1522,1583,21394,18960,89,15568,3303,2434
48181,"Grayson County, Texas",6820,5882,99,4241,1542,938,94482,86020,565,76049,9406,8462,123600,111494,799,96435,14260,12106
48183,"Gregg County, Texas",24002,19582,682,14880,4020,4420,68932,63561,638,56267,6656,5371,118809,105261,2533,87703,15025,13548
48185,"Grimes County, Texas",3364,2544,21,1964,559,820,14578,13227,200,11021,2006,1351,23791,20788,236,16764,3788,3003
48187,"Guadalupe County, Texas",11457,10736,54,9723,959,721,76500,72290,243,66967,5080,4210,148965,137962,605,125802,11555,11003
48189,"Hale County, Texas",1023,832,0,784,48,191,11192,10102,93,9185,824,1090,32193,27560,221,24675,2664,4633
48191,"Hall County, Texas",237,157,0,156,1,80,1711,1490,28,1149,313,221,3029,2438,29,1872,537,591
48193,"Hamilton County, Texas",19,19,0,19,0,0,6808,5772,32,4952,788,1036,7927,6658,32,5268,1358,1269
48195,"Hansford County, Texas",13,13,0,13,0,0,2883,2608,0,2474,134,275,5453,4906,0,3975,931,547
48197,"Hardeman County, Texas",282,151,0,115,36,131,2717,2455,4,2193,258,262,3954,3386,4,2902,480,568
48199,"Hardin County, Texas",3177,2851,0,1984,867,326,48266,44049,214,39424,4411,4217,55512,50655,214,44863,5578,4857
48201,"Harris County, Texas",843127,742521,3178,626626,112717,100606,1371094,1314942,4316,1241419,69207,56152,4484299,4053325,13579,3595159,444587,430974
48203,"Harrison County, Texas",13482,9192,33,6370,2789,4290,41918,36420,375,32323,3722,5498,65140,52031,414,44261,7356,13109
48205,"Hartley County, Texas",22,22,0,7,15,0,2781,2609,3,2428,178,172,4278,3897,3,3448,446,381
48207,"Haskell County, Texas",165,157,0,61,96,8,3714,2798,6,2420,372,916,4981,3795,6,3065,724,1186
48209,"Hays County, Texas",6216,6059,0,4874,1185,157,104258,101535,390,93511,7634,2723,187628,178323,509,155484,22330,9305
48211,"Hemphill County, Texas",30,30,0,26,4,0,2539,2459,0,2086,373,80,4108,3848,0,3058,790,260
48213,"Henderson County, Texas",5166,3423,9,2780,634,1743,62032,52439,596,44934,6909,9593,78394,63798,697,54562,8539,14596
48215,"Hidalgo County, Texas",3952,3687,0,2979,708,265,53925,48316,365,42256,5695,5609,829622,705994,4768,533293,167933,123628
48217,"Hill County, Texas",2133,1591,0,1332,259,542,24358,21789,218,18549,3022,2569,34110,30236,238,25631,4367,3874
48219,"Hockley County, Texas",769,715,0,593,122,54,10704,9586,58,8554,974,1118,22532,19624,85,17316,2223,2908
48221,"Hood County, Texas",335,285,0,285,0,50,46495,43894,185,39716,3993,2601,54716,51416,264,45886,5266,3300
48223,"Hopkins County, Texas",2370,1792,0,1520,272,578,26201,23704,241,21147,2316,2497,35441,31466,259,27648,3559,3975
48225,"Houston County, Texas",4586,3143,39,2154,950,1443,12894,10994,179,8247,2568,1900,19625,15762,238,11450,4074,3863
48227,"Howard County, Texas",1641,1457,66,1104,287,184,17307,15407,14,13779,1614,1900,31149,27539,129,23434,3976,3610
48229,"Hudspeth County, Texas",27,27,0,3,24,0,684,599,0,495,104,85,3116,2338,163,1465,710,778
48231,"Hunt County, Texas",6347,4888,47,3901,940,1459,64607,58394,534,49964,7896,6213,87586,78468,908,66791,10769,9118
48233,"Hutchinson County, Texas",435,293,0,250,43,142,15429,14124,52,12708,1364,1305,21569,19608,52,17673,1883,1961
48235,"Irion County, Texas",51,51,0,51,0,0,1153,1061,18,887,156,92,1592,1496,18,1209,269,96
48237,"Jack County, Texas",87,62,0,14,48,25,6390,5659,46,4476,1137,731,7666,6749,46,5219,1484,917
48239,"Jackson County, Texas",1038,711,0,481,230,327,8617,7914,28,6881,1005,703,14510,12682,28,10274,2380,1828
48241,"Jasper County, Texas",5626,4293,179,2254,1860,1333,26088,22717,308,15884,6525,3371,34506,29516,487,19501,9528,4990
48243,"Jeff Davis County, Texas",0,0,0,0,0,0,1332,1269,0,1027,242,63,2173,2034,0,1530,504,139
48245,"Jefferson County, Texas",80569,59199,291,45772,13136,21370,100595,88550,531,80135,7884,12045,238515,196156,920,166802,28434,42359
48247,"Jim Hogg County, Texas",0,0,0,0,0,0,305,218,0,213,5,87,5235,4169,123,3202,844,1066
48249,"Jim Wells County, Texas",178,167,0,113,54,11,7343,6162,60,5470,632,1181,40880,29508,729,24349,4430,11372
48251,"Johnson County, Texas",4026,3832,0,3268,564,194,116251,109186,1125,97723,10338,7065,157226,146911,1332,130046,15533,10315
48253,"Jones County, Texas",468,261,0,209,52,207,9194,8200,191,6582,1427,994,12687,11014,229,8652,2133,1673
48255,"Karnes County, Texas",316,151,8,133,10,165,5228,4250,81,3558,611,978,12114,8959,225,7400,1334,3155
48257,"Kaufman County, Texas",11826,9308,39,8145,1124,2518,75467,70838,420,63370,7048,4629,113404,102957,518,88788,13651,10447
48259,"Kendall County, Texas",243,243,19,224,0,0,29319,28229,397,26007,1825,1090,39798,37954,650,34394,2910,1844
48261,"Kenedy County, Texas",0,0,0,0,0,0,62,46,0,46,0,16,559,303,0,271,32,256
48263,"Kent County, Texas",0,0,0,0,0,0,492,433,0,393,40,59,633,533,4,480,49,100
48265,"Kerr County, Texas",604,502,0,336,166,102,34289,30627,192,27921,2514,3662,48942,42945,551,38587,3807,5997
48267,"Kimble County, Texas",0,0,0,0,0,0,3253,2839,6,2190,643,414,4373,3701,6,2802,893,672
48269,"King County, Texas",0,0,0,0,0,0,212,194,0,156,38,18,289,259,0,210,49,30
48271,"Kinney County, Texas",4,0,0,0,0,4,1382,1275,0,1092,183,107,3327,2658,0,2089,569,669
48273,"Kleberg County, Texas",904,760,0,670,90,144,6060,5586,28,4734,824,474,29567,26879,110,23485,3284,2688
48275,"Knox County, Texas",216,200,0,171,29,16,2114,1884,5,1662,217,230,3603,3120,5,2750,365,483
48277,"Lamar County, Texas",5938,4522,56,3395,1071,1416,36525,31953,131,26819,5003,4572,48582,41973,189,34288,7496,6609
48279,"Lamb County, Texas",640,556,11,472,73,84,5166,4484,44,3862,578,682,13156,11309,80,8533,2696,1847
48281,"Lampasas County, Texas",574,563,0,555,8,11,14739,13360,263,11429,1668,1379,20199,18311,323,14907,3081,1888
48283,"La Salle County, Texas",0,0,0,0,0,0,1204,1047,0,1034,13,157,6511,5519,0,4389,1130,992
48285,"Lavaca County, Texas",1282,740,0,689,51,542,14458,12473,270,11257,946,1985,19386,16156,273,14799,1084,3230
48287,"Lee County, Texas",1759,1260,0,1178,82,499,10514,9483,182,7962,1339,1031,16321,14349,182,12418,1749,1972
48289,"Leon County, Texas",1249,1044,18,857,169,205,12898,11340,45,10097,1198,1558,16847,14708,93,12757,1858,2139
48291,"Liberty County, Texas",6296,4880,16,4281,583,1416,49610,44281,353,39496,4432,5329,73077,63442,369,56201,6872,9635
48293,"Limestone County, Texas",4062,2737,60,1911,766,1325,13245,11304,20,8992,2292,1941,22471,18718,160,14680,3878,3753
48295,"Lipscomb County, Texas",10,10,0,10,0,0,2271,2076,11,1977,88,195,3447,3149,11,2971,167,298
48297,"Live Oak County, Texas",14,4,0,0,4,10,6750,5715,137,4664,914,1035,10495,7925,137,6276,1512,2570
48299,"Llano County, Texas",126,126,0,126,0,0,17453,15755,152,13318,2285,1698,19977,17928,159,15184,2585,2049
48301,"Loving County, Texas",0,0,0,0,0,0,55,55,0,40,15,0,74,66,0,44,22,8
48303,"Lubbock County, Texas",20317,16732,97,11753,4882,3585,155314,147542,1122,132757,13663,7772,285929,263547,1376,221526,40645,22382
48305,"Lynn County, Texas",91,73,0,73,0,18,2839,2580,18,2271,291,259,5745,4961,48,3990,923,784
48307,"McCulloch County, Texas",145,145,0,123,22,0,4944,4143,32,3553,558,801,7991,6719,40,5735,944,1272
48309,"McLennan County, Texas",33572,25466,48,18582,6836,8106,134104,124674,821,109001,14852,9430,236374,209440,1191,173322,34927,26934
48311,"McMullen County, Texas",0,0,0,0,0,0,292,233,0,212,21,59,600,461,0,388,73,139
48313,"Madison County, Texas",986,655,0,590,65,331,6832,6030,58,5340,632,802,9816,8637,62,7269,1306,1179
48315,"Marion County, Texas",2385,1557,35,986,536,828,7079,5954,78,4948,928,1125,10011,7990,113,6246,1631,2021
48317,"Martin County, Texas",24,24,0,24,0,0,2943,2663,111,2272,280,280,5477,4871,111,3597,1163,606
48319,"Mason County, Texas",0,0,0,0,0,0,2959,2342,19,1931,392,617,4111,3212,19,2547,646,899
48321,"Matagorda County, Texas",3713,2676,19,2070,587,1037,16253,14352,225,12012,2115,1901,36318,30370,272,24772,5326,5948
48323,"Maverick County, Texas",202,202,0,187,15,0,1429,1211,0,935,276,218,57039,46455,183,34836,11436,10584
48325,"Medina County, Texas",311,276,0,227,49,35,20981,19108,206,16605,2297,1873,45988,40578,869,34951,4758,5410
48327,"Menard County, Texas",10,0,0,0,0,10,1221,1062,8,824,230,159,2070,1613,8,1265,340,457
48329,"Midland County, Texas",9564,8361,0,7340,1021,1203,74682,71644,142,66410,5092,3038,157968,148081,142,134279,13660,9887
48331,"Milam County, Texas",2100,1663,33,1157,473,437,15089,12868,263,10626,1979,2221,23986,20307,296,16371,3640,3679
48333,"Mills County, Texas",0,0,0,0,0,0,3839,3422,76,3066,280,417,4714,4173,76,3672,425,541
48335,"Mitchell County, Texas",147,111,0,79,32,36,3723,3296,5,2733,558,427,6353,5466,5,4491,970,887
48337,"Montague County, Texas",26,26,0,12,14,0,16467,14895,80,12125,2690,1572,19048,16920,80,13390,3450,2128
48339,"Montgomery County, Texas",24290,22384,91,20226,2067,1906,361329,346448,1913,323753,20782,14881,531857,504168,2597,463356,38215,27689
48341,"Moore County, Texas",915,688,0,634,54,227,7329,6946,3,5989,954,383,21837,19769,3,16575,3191,2068
48343,"Morris County, Texas",2943,2345,0,2127,218,598,8061,7074,30,6646,398,987,12381,10634,30,9788,816,1747
48345,"Motley County, Texas",39,39,0,39,0,0,852,749,3,641,105,103,1114,1011,3,766,242,103
48347,"Nacogdoches County, Texas",10067,8728,49,7280,1399,1339,36194,32706,430,29235,3041,3488,59920,53392,751,46378,6263,6528
48349,"Navarro County, Texas",6240,4954,1,3677,1276,1286,27050,24063,235,20638,3190,2987,47317,41610,358,33659,7593,5707
48351,"Newton County, Texas",2994,2312,0,1365,947,682,10356,8772,161,6583,2028,1584,14019,11708,161,8367,3180,2311
48353,"Nolan County, Texas",707,597,0,262,335,110,8357,7705,6,6591,1108,652,14651,13036,6,10550,2480,1615
48355,"Nueces County, Texas",12771,10838,0,9247,1591,1933,105352,98469,213,91094,7162,6883,350488,314853,483,280084,34286,35635
48357,"Ochiltree County, Texas",32,32,0,32,0,0,4634,4430,48,3677,705,204,10419,9551,61,7225,2265,868
48359,"Oldham County, Texas",4,4,0,4,0,0,1270,1145,1,1037,107,125,1499,1324,10,1189,125,175
48361,"Orange County, Texas",6810,5463,10,4503,950,1347,67647,61264,216,54918,6130,6383,83085,74367,241,65840,8286,8718
48363,"Palo Pinto County, Texas",650,570,0,459,111,80,21056,18572,211,15689,2672,2484,27843,24198,229,20205,3764,3645
48365,"Panola County, Texas",3713,2277,7,1767,503,1436,17096,14766,294,13166,1306,2330,23138,19007,301,16583,2123,4131
48367,"Parker County, Texas",1420,1316,23,1156,137,104,105129,100013,524,91203,8286,5116,123943,117085,569,105100,11416,6858
48369,"Parmer County, Texas",159,108,0,60,48,51,3400,2976,107,2356,513,424,9789,7849,139,5673,2037,1940
48371,"Pecos County, Texas",130,119,0,119,0,11,3498,3133,35,2489,609,365,13677,11443,35,9222,2186,2234
48373,"Polk County, Texas",3938,3025,172,2173,680,913,32361,27896,430,22774,4692,4465,43456,36449,613,29056,6780,7007
48375,"Potter County, Texas",9415,7590,12,5507,2071,1825,51973,46601,141,40574,5886,5372,114167,98903,355,80178,18370,15264
48377,"Presidio County, Texas",0,0,0,0,0,0,975,873,0,765,108,102,7186,5283,0,3776,1507,1903
48379,"Rains County, Texas",157,124,0,107,17,33,9601,8423,94,7246,1083,1178,11178,9630,94,8130,1406,1548
48381,"Randall County, Texas",3427,2929,0,2600,329,498,94523,89448,470,82991,5987,5075,128223,121053,664,110774,9615,7170
48383,"Reagan County, Texas",25,23,0,23,0,2,1062,1019,26,874,119,43,3698,3297,26,2445,826,401
48385,"Real County, Texas",0,0,0,0,0,0,2605,2318,48,1668,602,287,3242,2723,48,1958,717,519
48387,"Red River County, Texas",2128,1635,0,1314,321,493,8886,7319,133,6055,1131,1567,12139,9848,139,7992,1717,2291
48389,"Reeves County, Texas",468,290,0,288,2,178,2417,2135,3,1902,230,282,12340,10092,242,7404,2446,2248
48391,"Refugio County, Texas",375,276,0,249,27,99,2997,2604,92,2228,284,393,7116,6110,195,4975,940,1006
48393,"Roberts County, Texas",0,0,0,0,0,0,805,771,0,721,50,34,889,855,0,786,69,34
48395,"Robertson County, Texas",3278,2493,0,2006,487,785,9530,8426,42,7565,819,1104,16521,14381,42,12541,1798,2140
48397,"Rockwall County, Texas",5303,4924,0,4430,494,379,64934,63204,163,59893,3148,1730,89742,87165,177,82034,4954,2577
48399,"Runnels County, Texas",99,62,0,11,51,37,6279,5280,66,4629,585,999,10036,8026,74,6729,1223,2010
48401,"Rusk County, Texas",7461,5490,160,3490,1840,1971,32192,28224,592,22535,5097,3968,48135,40416,1005,30171,9240,7719
48403,"Sabine County, Texas",789,649,0,435,214,140,8895,7795,69,6767,959,1100,10327,9044,69,7664,1311,1283
48405,"San Augustine County, Texas",1666,1089,20,734,335,577,5612,4161,55,3768,338,1451,8141,5967,75,5211,681,2174
48407,"San Jacinto County, Texas",3074,2583,0,1877,706,491,20447,18339,134,15421,2784,2108,27289,24196,206,19878,4112,3093
48409,"San Patricio County, Texas",1035,943,30,744,169,92,25947,24666,106,21508,3052,1281,66087,60004,175,46606,13223,6083
48411,"San Saba County, Texas",0,0,0,0,0,0,3535,2948,35,2619,294,587,5148,4177,35,3516,626,971
48413,"Schleicher County, Texas",9,9,0,9,0,0,1489,1416,29,1106,281,73,3122,2809,29,2288,492,313
48415,"Scurry County, Texas",414,375,0,357,18,39,8525,8086,86,7140,860,439,15485,14409,86,12281,2042,1076
48417,"Shackelford County, Texas",0,0,0,0,0,0,2855,2378,2,2060,316,477,3317,2771,2,2364,405,546
48419,"Shelby County, Texas",4853,3361,241,2152,968,1492,15806,13143,274,10851,2018,2663,25473,20653,886,15373,4394,4820
48421,"Sherman County, Texas",5,5,0,5,0,0,1687,1552,6,1400,146,135,3034,2670,6,2352,312,364
48423,"Smith County, Texas",36930,30757,119,26384,4254,6173,131492,122638,486,111620,10532,8854,216938,196524,645,174804,21075,20414
48425,"Somervell County, Texas",0,0,0,0,0,0,6563,6012,15,4315,1682,551,8321,7673,15,5632,2026,648
48427,"Starr County, Texas",9,0,0,0,0,9,324,217,0,173,44,107,62835,53609,195,34304,19110,9226
48429,"Stephens County, Texas",101,79,0,53,26,22,6444,5342,46,4384,912,1102,8801,7376,71,5910,1395,1425
48431,"Sterling County, Texas",0,0,0,0,0,0,630,543,0,462,81,87,1098,975,0,812,163,123
48433,"Stonewall County, Texas",30,19,0,10,9,11,755,615,19,547,49,140,1031,858,19,759,80,173
48435,"Sutton County, Texas",19,19,0,0,19,0,1519,1361,0,1162,199,158,3869,3260,0,2476,784,609
48437,"Swisher County, Texas",332,248,0,214,34,84,3405,3134,28,2885,221,271,6876,5816,29,5201,586,1060
48439,"Tarrant County, Texas",310665,283909,3521,233813,46575,26756,945407,908886,4067,857220,47599,36521,1959378,1842877,12073,1638272,192532,116501
48441,"Taylor County, Texas",9390,7593,0,5572,2021,1797,83002,77369,395,67755,9219,5633,128676,117415,439,97076,19900,11261
48443,"Terrell County, Texas",23,12,0,12,0,11,239,224,0,209,15,15,721,525,0,415,110,196
48445,"Terry County, Texas",416,310,0,295,15,106,4830,4336,47,3396,893,494,11602,10183,53,7990,2140,1419
48447,"Throckmorton County, Texas",0,0,0,0,0,0,1261,1074,50,851,173,187,1528,1267,50,945,272,261
48449,"Titus County, Texas",2937,2179,0,1849,330,758,14907,13193,134,11636,1423,1714,32376,26613,362,22065,4186,5763
48451,"Tom Green County, Texas",4281,3675,0,3224,451,606,59902,54867,141,49658,5068,5035,110811,97909,333,84483,13093,12902
48453,"Travis County, Texas",93136,85169,524,72210,12435,7967,566799,552078,1234,524059,26785,14721,1152727,1081241,2575,981162,97504,71486
48455,"Trinity County, Texas",1367,945,0,425,520,422,11372,9711,197,7362,2152,1661,14363,12138,222,8756,3160,2225
48457,"Tyler County, Texas",1164,871,0,367,504,293,16152,13889,77,10916,2896,2263,18722,16011,77,12280,3654,2711
48459,"Upshur County, Texas",3503,2865,0,2405,460,638,32372,29252,643,25602,3007,3120,39928,35387,643,30831,3913,4541
48461,"Upton County, Texas",237,234,0,126,108,3,1500,1406,0,937,469,94,3510,3132,5,2036,1091,378
48463,"Uvalde County, Texas",48,48,0,48,0,0,7128,6225,188,5492,545,903,26538,21746,510,18648,2588,4792
48465,"Val Verde County, Texas",644,619,0,334,285,25,7328,7048,0,6510,538,280,47325,39042,98,34169,4775,8283
48467,"Van Zandt County, Texas",1364,1209,0,760,449,155,44609,39688,449,30844,8395,4921,52874,46544,466,35509,10569,6330
48469,"Victoria County, Texas",5507,3929,0,2905,1024,1578,40976,37938,300,33439,4199,3038,90160,79207,336,64398,14473,10953
48471,"Walker County, Texas",10693,9278,63,7380,1835,1415,31567,29797,165,25861,3771,1770,52159,47845,465,39978,7402,4314
48473,"Waller County, Texas",8931,7072,46,5296,1730,1859,20021,18557,235,15951,2371,1464,43542,37957,426,29005,8526,5585
48475,"Ward County, Texas",586,480,0,298,182,106,4701,4174,24,3764,386,527,11370,9992,53,8413,1526,1378
48477,"Washington County, Texas",5162,3973,105,2844,1024,1189,21232,18830,440,14731,3659,2402,32335,27613,644,21083,5886,4722
48479,"Webb County, Texas",999,935,0,876,59,64,9179,8173,23,7349,801,1006,266436,202672,1782,156262,44628,63764
48481,"Wharton County, Texas",5809,4014,57,2633,1324,1795,18407,16535,264,14400,1871,1872,40868,34269,526,27743,6000,6599
48483,"Wheeler County, Texas",160,127,0,108,19,33,3764,3487,76,2849,562,277,5530,4959,89,4125,745,571
48485,"Wichita County, Texas",9873,8133,9,6157,1967,1740,79708,73191,335,64173,8683,6517,116271,105136,476,89411,15249,11135
48487,"Wilbarger County, Texas",1001,831,0,760,71,170,7348,6362,5,5644,713,986,12323,10477,14,8796,1667,1846
48489,"Willacy County, Texas",65,65,0,65,0,0,2300,1951,0,1824,127,349,20134,14940,265,11116,3559,5194
48491,"Williamson County, Texas",30662,29127,163,26622,2342,1535,307065,298303,886,286682,10735,8762,503664,486310,1382,461401,23527,17354
48493,"Wilson County, Texas",610,561,0,493,68,49,26841,24930,262,22802,1866,1911,46619,42426,408,38615,3403,4193
48495,"Winkler County, Texas",268,267,0,267,0,1,2839,2579,20,2297,262,260,7679,7054,114,5832,1108,625
48497,"Wise County, Texas",494,467,0,386,81,27,48564,45071,510,37870,6691,3493,62214,57329,550,47039,9740,4885
48499,"Wood County, Texas",1920,1077,0,842,235,843,35279,31341,523,28183,2635,3938,41821,36707,576,32482,3649,5114
48501,"Yoakum County, Texas",57,57,0,9,48,0,2813,2624,0,2478,146,189,8481,7494,0,5894,1600,987
48503,"Young County, Texas",210,153,0,141,12,57,14130,12643,61,10973,1609,1487,17873,15980,73,13097,2810,1893
48505,"Zapata County, Texas",122,112,0,112,0,10,738,610,0,492,118,128,14378,12483,153,7914,4416,1895
48507,"Zavala County, Texas",25,25,0,0,25,0,618,542,0,320,222,76,11926,9159,152,5898,3109,2767
49001,"Beaver County, Utah",0,0,0,0,0,0,5653,5219,148,4715,356,434,6345,5765,148,5144,473,580
49003,"Box Elder County, Utah",247,218,0,211,7,29,45208,42623,249,39312,3062,2585,51744,48297,259,44341,3697,3447
49005,"Cache County, Utah",936,874,0,598,276,62,98370,95955,272,88162,7521,2415,117382,113893,378,104129,9386,3489
49007,"Carbon County, Utah",115,99,0,99,0,16,16694,15315,82,13691,1542,1379,20023,18332,86,16435,1811,1691
49009,"Daggett County, Utah",0,0,0,0,0,0,567,565,0,542,23,2,567,565,0,542,23,2
49011,"Davis County, Utah",4281,4228,0,3597,631,53,281444,275688,1382,261403,12903,5756,332976,325247,1553,307482,16212,7729
49013,"Duchesne County, Utah",38,38,0,38,0,0,17019,15868,43,14687,1138,1151,19879,18403,43,16988,1372,1476
49015,"Emery County, Utah",13,13,0,13,0,0,9442,8881,22,7949,910,561,10328,9472,35,8435,1002,856
49017,"Garfield County, Utah",8,8,0,8,0,0,4318,4014,32,3424,558,304,4781,4454,41,3737,676,327
49019,"Grand County, Utah",23,23,0,23,0,0,8328,7926,91,7324,511,402,9436,9007,91,7976,940,429
49021,"Iron County, Utah",252,252,0,246,6,0,41373,39852,136,35231,4485,1521,47862,45760,140,40686,4934,2102
49023,"Juab County, Utah",24,24,0,24,0,0,9752,9275,148,8073,1054,477,10524,10020,152,8596,1272,504
49025,"Kane County, Utah",9,9,0,9,0,0,6570,6206,84,5210,912,364,7143,6762,98,5548,1116,381
49027,"Millard County, Utah",39,39,0,39,0,0,10374,9979,133,9141,705,395,12444,11810,160,10460,1190,634
49029,"Morgan County, Utah",39,39,0,39,0,0,10498,10319,42,10120,157,179,11014,10816,42,10540,234,198
49031,"Piute County, Utah",0,0,0,0,0,0,1757,1562,18,1346,198,195,1826,1629,18,1399,212,197
49033,"Rich County, Utah",2,2,0,0,2,0,2045,1977,137,1574,266,68,2302,2176,137,1755,284,126
49035,"Salt Lake County, Utah",18833,17319,0,14326,2993,1514,788504,762380,4043,695980,62357,26124,1093919,1051541,5783,945998,99760,42378
49037,"San Juan County, Utah",10,10,0,0,10,0,6421,5921,158,5115,648,500,14782,9994,158,7370,2466,4788
49039,"Sanpete County, Utah",15,9,0,9,0,6,23052,21738,231,18932,2575,1314,25686,24241,231,21103,2907,1445
49041,"Sevier County, Utah",71,69,0,69,0,2,18987,17981,110,16160,1711,1006,20566,19478,115,17295,2068,1088
49043,"Summit County, Utah",243,240,0,143,97,3,33506,32840,86,31508,1246,666,39490,38107,97,36261,1749,1383
49045,"Tooele County, Utah",303,293,26,235,32,10,52607,51085,199,49020,1866,1522,62989,60726,297,57759,2670,2263
49047,"Uintah County, Utah",169,155,0,113,42,14,29492,28026,226,25941,1859,1466,35966,33509,226,30543,2740,2457
49049,"Utah County, Utah",3240,3228,0,2875,353,12,466115,459268,1383,421690,36195,6847,561249,550902,1545,499106,50251,10347
49051,"Wasatch County, Utah",26,26,0,26,0,0,24387,23946,123,22881,942,441,29135,28302,220,26745,1337,833
49053,"Washington County, Utah",983,918,0,713,205,65,130513,125716,640,113463,11613,4797,153543,146712,640,131468,14604,6831
49055,"Wayne County, Utah",3,3,0,3,0,0,2438,2296,167,1899,230,142,2645,2486,167,2032,287,159
49057,"Weber County, Utah",2410,2183,25,1968,190,227,184949,178315,929,163762,13624,6634,240920,229836,1210,206993,21633,11084
50001,"Addison County, Vermont",267,248,0,196,52,19,32076,29403,281,26965,2157,2673,33931,31061,281,28460,2320,2870
50003,"Bennington County, Vermont",227,214,6,185,23,13,32962,30359,290,27495,2574,2603,34584,31738,296,28732,2710,2846
50005,"Caledonia County, Vermont",174,172,0,154,18,2,28126,25067,367,21571,3129,3059,29434,26182,367,22559,3256,3252
50007,"Chittenden County, Vermont",3908,3520,0,3278,242,388,135071,128896,775,120451,7670,6175,151138,144172,790,134681,8701,6966
50009,"Essex County, Vermont",63,52,0,52,0,11,5907,4979,88,4487,404,928,6174,5223,88,4727,408,951
50011,"Franklin County, Vermont",289,208,0,181,27,81,45609,41417,322,38405,2690,4192,48361,43904,330,40741,2833,4457
50013,"Grand Isle County, Vermont",13,13,0,0,13,0,6479,6141,44,5598,499,338,6950,6594,44,6026,524,356
50015,"Lamoille County, Vermont",204,204,0,160,44,0,23281,21718,252,19523,1943,1563,24520,22919,256,20644,2019,1601
50017,"Orange County, Vermont",164,159,0,146,13,5,26991,24163,540,21117,2506,2828,28189,25251,557,22096,2598,2938
50019,"Orleans County, Vermont",92,92,0,92,0,0,24948,21650,224,19042,2384,3298,26120,22664,228,19998,2438,3456
50021,"Rutland County, Vermont",364,364,0,349,15,0,55016,49786,227,44335,5224,5230,57408,52028,235,46436,5357,5380
50023,"Washington County, Vermont",443,398,0,369,29,45,53434,48417,288,44391,3738,5017,56466,51160,292,46966,3902,5306
50025,"Windham County, Vermont",244,195,0,178,17,49,39056,35787,447,30663,4677,3269,41596,38197,488,32653,5056,3399
50027,"Windsor County, Vermont",339,332,0,219,113,7,51883,47535,430,43788,3317,4348,54516,49977,442,45837,3698,4539
51001,"Accomack County, Virginia",8646,6347,0,4383,1964,2299,19586,17401,202,14798,2401,2185,31753,26678,202,21103,5373,5075
51003,"Albemarle County, Virginia",9185,8317,5,7357,955,868,76383,72175,418,66544,5213,4208,97440,91796,641,83702,7453,5644
51005,"Alleghany County, Virginia",778,532,0,437,95,246,13995,11851,141,10131,1579,2144,15174,12755,141,10880,1734,2419
51007,"Amelia County, Virginia",3008,2155,169,1332,654,853,9156,8494,24,7413,1057,662,12660,11145,193,9218,1734,1515
51009,"Amherst County, Virginia",5181,4121,171,2584,1366,1060,23471,19865,278,16890,2697,3606,30694,25728,464,20758,4506,4966
51011,"Appomattox County, Virginia",3093,2128,23,1109,996,965,11799,10042,109,8640,1293,1757,15389,12609,132,10128,2349,2780
51013,"Arlington County, Virginia",19452,17922,126,15469,2327,1530,141146,138380,354,134891,3135,2766,226443,217071,1033,206328,9710,9372
51015,"Augusta County, Virginia",1617,1248,0,1008,240,369,66244,57539,367,50178,6994,8705,70899,61508,367,53461,7680,9391
51017,"Bath County, Virginia",115,115,0,92,23,0,3698,3147,292,2608,247,551,4316,3749,292,3187,270,567
51019,"Bedford County, Virginia",5264,3805,173,2594,1038,1459,67830,60137,887,52490,6760,7693,76832,67503,1060,58370,8073,9329
51021,"Bland County, Virginia",12,12,0,0,12,0,5669,5004,62,4336,606,665,5732,5054,62,4365,627,678
51023,"Botetourt County, Virginia",957,815,61,631,123,142,30632,27857,88,24930,2839,2775,32856,29889,151,26574,3164,2967
51025,"Brunswick County, Virginia",7562,6037,79,4506,1452,1525,6075,4993,20,4486,487,1082,14295,11688,99,9449,2140,2607
51027,"Buchanan County, Virginia",126,120,0,120,0,6,21184,16020,411,13387,2222,5164,21645,16437,411,13773,2253,5208
51029,"Buckingham County, Virginia",4735,3945,20,2507,1418,790,9719,8218,200,6534,1484,1501,15048,12751,228,9477,3046,2297
51031,"Campbell County, Virginia",7552,6232,21,5171,1040,1320,44004,38039,707,33539,3793,5965,54661,46829,853,40791,5185,7832
51033,"Caroline County, Virginia",7919,6521,102,5240,1179,1398,18033,16311,231,13984,2096,1722,27812,24545,381,20583,3581,3267
51035,"Carroll County, Virginia",79,79,0,79,0,0,28165,22927,148,19683,3096,5238,29603,24194,169,20627,3398,5409
51036,"Charles City County, Virginia",3245,2266,61,1708,497,979,2915,2613,68,1965,580,302,7022,5593,146,4218,1229,1429
51037,"Charlotte County, Virginia",3559,2206,108,1535,563,1353,8121,6061,245,4949,867,2060,12016,8603,353,6749,1501,3413
51041,"Chesterfield County, Virginia",73530,70314,118,65933,4263,3216,209916,200787,579,191192,9016,9129,331771,317176,725,300715,15736,14595
51043,"Clarke County, Virginia",631,382,0,337,45,249,12327,11448,43,9841,1564,879,14126,12909,43,11110,1756,1217
51045,"Craig County, Virginia",0,0,0,0,0,0,5094,4090,108,3469,513,1004,5114,4110,108,3469,533,1004
51047,"Culpeper County, Virginia",6567,5538,169,4557,812,1029,34808,32439,464,29713,2262,2369,48370,44527,633,39805,4089,3843
51049,"Cumberland County, Virginia",3169,2266,43,1239,984,903,6153,5537,16,4407,1114,616,9753,8234,59,5969,2206,1519
51051,"Dickenson County, Virginia",42,42,0,42,0,0,14525,11307,375,9015,1917,3218,14746,11502,375,9130,1997,3244
51053,"Dinwiddie County, Virginia",8551,7223,0,5820,1403,1328,17090,15442,327,12715,2400,1648,27299,24278,327,19984,3967,3021
51057,"Essex County, Virginia",4143,3060,0,2046,1014,1083,5957,5079,203,3911,965,878,10897,8898,203,6661,2034,1999
51059,"Fairfax County, Virginia",108264,104176,290,97445,6441,4088,585332,574090,1240,559657,13193,11242,1132989,1104436,2988,1057250,44198,28553
51061,"Fauquier County, Virginia",5014,4337,13,3968,356,677,55101,51924,484,48566,2874,3177,68030,63942,497,59722,3723,4088
51063,"Floyd County, Virginia",393,284,0,225,59,109,14526,12154,295,10835,1024,2372,15504,12740,295,11269,1176,2764
51065,"Fluvanna County, Virginia",3125,2625,0,1918,707,500,19868,18809,134,17588,1087,1059,24922,23331,134,21014,2183,1591
51067,"Franklin County, Virginia",4004,3227,31,2294,902,777,48137,40769,561,34666,5542,7368,54722,46464,641,38984,6839,8258
51069,"Frederick County, Virginia",3038,2553,0,2291,262,485,69937,64679,540,56640,7499,5258,82541,76212,547,65964,9701,6329
51071,"Giles County, Virginia",379,279,0,275,4,100,15943,13495,343,12220,932,2448,16738,14190,343,12848,999,2548
51073,"Gloucester County, Virginia",3027,2558,0,2178,380,469,31315,28983,208,26640,2135,2332,36765,33775,224,30689,2862,2990
51075,"Goochland County, Virginia",3059,2223,87,1681,455,836,16675,16041,107,14854,1080,634,20983,19428,194,17618,1616,1555
51077,"Grayson County, Virginia",285,191,0,191,0,94,13932,11036,187,9270,1579,2896,14980,11931,187,10112,1632,3049
51079,"Greene County, Virginia",1164,1083,0,792,291,81,15868,14523,89,13032,1402,1345,19066,17465,89,15432,1944,1601
51081,"Greensville County, Virginia",4768,3827,90,2304,1433,941,3404,2985,30,2336,619,419,8497,7137,120,4948,2069,1360
51083,"Halifax County, Virginia",12306,8533,184,5545,2804,3773,20518,16238,338,13397,2503,4280,34270,25877,522,19772,5583,8393
51085,"Hanover County, Virginia",9135,8084,155,7299,630,1051,85781,81486,507,76290,4689,4295,101379,95612,724,89156,5732,5767
51087,"Henrico County, Virginia",94587,86826,533,75439,10854,7761,174533,164826,448,157116,7262,9707,321717,302769,1016,279500,22253,18948
51089,"Henry County, Virginia",11257,9206,89,7236,1881,2051,36105,30903,546,26317,4040,5202,51279,43643,635,36320,6688,7636
51091,"Highland County, Virginia",0,0,0,0,0,0,2200,1796,66,1550,180,404,2213,1809,66,1561,182,404
51093,"Isle of Wight County, Virginia",7940,6713,43,5339,1331,1227,25374,23755,176,21238,2341,1619,35811,32803,229,28313,4261,3008
51095,"James City County, Virginia",9201,7495,46,6305,1144,1706,54904,52410,98,49077,3235,2494,71996,67522,144,62780,4598,4474
51097,"King and Queen County, Virginia",1840,1278,40,666,572,562,4658,3740,77,3132,531,918,7052,5567,117,4232,1218,1485
51099,"King George County, Virginia",4160,3510,24,3254,232,650,18732,18146,69,16822,1255,586,25386,24104,93,22412,1599,1282
51101,"King William County, Virginia",2984,1845,103,816,926,1139,12408,11556,70,9674,1812,852,16276,14112,175,11176,2761,2164
51103,"Lancaster County, Virginia",3000,2212,41,1605,566,788,7327,6673,85,6047,541,654,10734,9272,161,7991,1120,1462
51105,"Lee County, Virginia",308,246,104,97,45,62,22394,17617,444,12297,4876,4777,22932,18079,548,12584,4947,4853
51107,"Loudoun County, Virginia",28057,27181,41,25995,1145,876,214973,211033,388,204451,6194,3940,372800,365161,670,352047,12444,7639
51109,"Louisa County, Virginia",5271,4008,17,3230,761,1263,26867,24706,449,21375,2882,2161,34692,31104,466,26359,4279,3588
51111,"Lunenburg County, Virginia",3274,1858,113,1333,412,1416,7076,5706,202,4616,888,1370,11422,8490,322,6855,1313,2932
51113,"Madison County, Virginia",816,710,13,359,338,106,11009,9705,344,7808,1553,1304,12874,11446,357,9120,1969,1428
51115,"Mathews County, Virginia",914,741,0,545,196,173,7480,6823,131,5615,1077,657,8721,7872,131,6460,1281,849
51117,"Mecklenburg County, Virginia",10503,7267,294,5182,1791,3236,18204,14770,364,12516,1890,3434,29967,22884,658,18374,3852,7083
51119,"Middlesex County, Virginia",1826,1179,0,710,469,647,8093,7375,56,6156,1163,718,10313,8939,56,7239,1644,1374
51121,"Montgomery County, Virginia",3930,3613,0,3234,379,317,74512,69806,172,65171,4463,4706,88561,83479,194,77845,5440,5082
51125,"Nelson County, Virginia",1882,1469,38,852,579,413,12055,10474,265,8075,2134,1581,14754,12750,303,9320,3127,2004
51127,"New Kent County, Virginia",2098,1876,57,1090,729,222,16058,15446,450,13477,1519,612,19975,19104,514,15870,2720,871
51131,"Northampton County, Virginia",4059,2690,17,1738,935,1369,6352,5705,47,4998,660,647,11681,9587,64,7741,1782,2094
51133,"Northumberland County, Virginia",3511,2874,13,2231,630,637,8568,7371,29,6490,852,1197,12254,10419,42,8895,1482,1835
51135,"Nottoway County, Virginia",5349,3918,27,3275,616,1431,7746,6255,33,5486,736,1491,13745,10681,60,9039,1582,3064
51137,"Orange County, Virginia",4220,3533,54,2797,682,687,27459,25531,227,21905,3399,1928,34732,31862,281,26533,5048,2870
51139,"Page County, Virginia",288,163,0,61,102,125,22253,17888,447,14646,2795,4365,23497,18963,447,15429,3087,4534
51141,"Patrick County, Virginia",952,770,46,614,110,182,15898,12768,109,11167,1492,3130,17655,14181,211,12175,1795,3474
51143,"Pittsylvania County, Virginia",12613,9731,202,7077,2452,2882,45511,38645,450,32486,5709,6866,60921,50993,662,41489,8842,9928
51145,"Powhatan County, Virginia",1491,1298,0,1031,267,193,23250,22309,270,20838,1201,941,25720,24570,270,22760,1540,1150
51147,"Prince Edward County, Virginia",6552,4153,193,2760,1200,2399,11019,9558,138,8389,1031,1461,18354,14377,344,11802,2231,3977
51149,"Prince George County, Virginia",10244,9508,114,8171,1223,736,19347,18116,46,15891,2179,1231,33665,31352,164,27695,3493,2313
51153,"Prince William County, Virginia",93003,89705,270,84955,4480,3298,199075,194904,321,189906,4677,4171,446653,434387,804,414856,18727,12266
51155,"Pulaski County, Virginia",1460,1177,41,646,490,283,30373,25767,284,21821,3662,4606,33300,28331,369,23588,4374,4969
51157,"Rappahannock County, Virginia",273,210,0,181,29,63,6562,5993,173,5078,742,569,7340,6660,173,5664,823,680
51159,"Richmond County, Virginia",1427,1063,0,916,147,364,4807,4052,67,3518,467,755,7147,5985,67,5024,894,1162
51161,"Roanoke County, Virginia",5050,4790,0,4626,164,260,79215,73400,152,68147,5101,5815,91278,85100,152,78719,6229,6178
51163,"Rockbridge County, Virginia",608,548,58,490,0,60,20722,16873,404,15011,1458,3849,22230,18227,462,16254,1511,4003
51165,"Rockingham County, Virginia",1812,1721,0,1572,149,91,69105,59382,731,52764,5887,9723,76957,66167,731,58878,6558,10790
51167,"Russell County, Virginia",113,93,0,93,0,20,26535,20688,266,16953,3469,5847,27242,21321,266,17574,3481,5921
51169,"Scott County, Virginia",140,126,0,96,30,14,20936,16709,117,14638,1954,4227,21566,17310,126,15071,2113,4256
51171,"Shenandoah County, Virginia",695,552,0,479,73,143,37586,33244,323,29885,3036,4342,42418,37441,323,33246,3872,4977
51173,"Smyth County, Virginia",563,500,0,391,109,63,29035,24080,384,20758,2938,4955,30611,25503,384,22020,3099,5108
51175,"Southampton County, Virginia",5308,4076,160,3220,696,1232,10334,9522,173,8000,1349,812,16610,14528,333,12002,2193,2082
51177,"Spotsylvania County, Virginia",20555,19492,74,17837,1581,1063,90107,85871,299,80383,5189,4236,129705,123299,384,115097,7818,6406
51179,"Stafford County, Virginia",23249,22775,27,21952,796,474,87751,85268,175,81973,3120,2483,137764,133886,202,129155,4529,3878
51181,"Surry County, Virginia",3043,2495,156,1627,712,548,3474,3117,61,2461,595,357,6670,5764,217,4212,1335,906
51183,"Sussex County, Virginia",3364,2575,0,2087,488,789,3356,2930,40,2473,417,426,6947,5727,40,4775,912,1220
51185,"Tazewell County, Virginia",879,699,0,646,53,180,39180,32514,167,29869,2478,6666,41166,34266,167,31332,2767,6900
51187,"Warren County, Virginia",1319,1154,0,1017,137,165,33534,31361,392,28269,2700,2173,38193,35596,469,31831,3296,2597
51191,"Washington County, Virginia",608,522,24,400,98,86,50479,43629,554,38718,4357,6850,52770,45672,600,40436,4636,7098
51193,"Westmoreland County, Virginia",4634,3765,19,3068,678,869,11175,10139,31,9272,836,1036,17471,15189,118,13435,1636,2282
51195,"Wise County, Virginia",645,528,0,391,137,117,35090,30134,437,24973,4724,4956,36555,31239,442,25681,5116,5316
51197,"Wythe County, Virginia",878,518,0,297,221,360,27092,22594,151,19140,3303,4498,28791,23732,151,20004,3577,5059
51199,"York County, Virginia",8521,7936,49,7347,540,585,47598,46259,87,44521,1651,1339,66075,63840,215,60879,2746,2235
51510,"Alexandria city, Virginia",33499,30366,25,26738,3603,3133,79352,77673,99,75402,2172,1679,153209,145849,249,134822,10778,7360
51520,"Bristol city, Virginia",1250,999,0,825,174,251,14671,12620,47,11409,1164,2051,16659,14357,47,12812,1498,2302
51530,"Buena Vista city, Virginia",81,38,0,38,0,43,5384,3962,194,3426,342,1422,6012,4547,194,3631,722,1465
51540,"Charlottesville city, Virginia",8460,7023,92,5426,1505,1437,29045,27545,74,24815,2656,1500,43750,40497,166,35197,5134,3253
51550,"Chesapeake city, Virginia",66466,60940,464,53587,6889,5526,134987,129289,382,124272,4635,5698,229028,217286,872,204264,12150,11742
51570,"Colonial Heights city, Virginia",2284,2168,0,1763,405,116,12943,11243,236,10052,955,1700,17396,15421,236,13644,1541,1975
51580,"Covington city, Virginia",722,645,0,534,111,77,4569,3525,58,3004,463,1044,5587,4446,58,3784,604,1141
51590,"Danville city, Virginia",20002,15582,213,12735,2634,4420,17441,14583,105,12974,1504,2858,40332,32672,318,28011,4343,7660
51595,"Emporia city, Virginia",3411,2541,51,1893,597,870,1504,1366,13,1126,227,138,5253,4245,64,3342,839,1008
51600,"Fairfax city, Virginia",1059,1036,14,919,103,23,13163,12790,38,12582,170,373,22970,22517,60,21681,776,453
51610,"Falls Church city, Virginia",640,595,0,595,0,45,9956,9881,0,9475,406,75,13799,13557,0,12973,584,242
51620,"Franklin city, Virginia",4868,3893,4,2664,1225,975,3020,2791,6,2706,79,229,8203,6994,10,5622,1362,1209
51630,"Fredericksburg city, Virginia",6061,5307,12,4278,1017,754,14824,14068,20,13039,1009,756,25459,23949,32,21494,2423,1510
51640,"Galax city, Virginia",436,316,0,301,15,120,4844,3971,8,3579,384,873,6388,5305,8,4551,746,1083
51650,"Hampton city, Virginia",65373,60509,222,51653,8634,4864,52230,48779,271,44743,3765,3451,131765,122912,549,109430,12933,8853
51660,"Harrisonburg city, Virginia",2978,2656,0,1987,669,322,30009,27916,26,22522,5368,2093,45668,41853,115,33582,8156,3815
51670,"Hopewell city, Virginia",8987,7060,0,5735,1325,1927,10773,8908,169,7664,1075,1865,22115,18074,169,15220,2685,4041
51678,"Lexington city, Virginia",498,449,0,347,102,49,2706,2190,0,1963,227,516,3573,2975,0,2622,353,598
51680,"Lynchburg city, Virginia",21052,16183,172,12183,3828,4869,41882,38802,195,34611,3996,3080,68482,60145,381,51350,8414,8337
51683,"Manassas city, Virginia",5471,5274,0,5059,215,197,17627,17039,50,16290,699,588,41315,39168,222,36646,2300,2147
51685,"Manassas Park city, Virginia",2202,2187,0,1589,598,15,5800,5575,0,5340,235,225,16117,15723,0,14359,1364,394
51690,"Martinsville city, Virginia",5988,5267,0,4157,1110,721,5854,4883,40,4375,468,971,12848,10966,40,9264,1662,1882
51700,"Newport News city, Virginia",72036,65081,49,53591,11441,6955,74214,70034,336,64618,5080,4180,172047,159002,385,139787,18830,13045
51710,"Norfolk city, Virginia",93698,82838,68,70773,11997,10860,94640,89424,310,83384,5730,5216,219773,202373,405,181746,20222,17400
51720,"Norton city, Virginia",151,141,0,141,0,10,3585,3169,15,2265,889,416,3987,3558,15,2654,889,429
51730,"Petersburg city, Virginia",23822,19302,97,15583,3622,4520,4500,3931,25,3598,308,569,31266,25804,184,21364,4256,5462
51735,"Poquoson city, Virginia",118,66,0,66,0,52,11049,10382,0,10051,331,667,11970,11244,0,10909,335,726
51740,"Portsmouth city, Virginia",48996,42707,236,35304,7167,6289,35376,32480,96,29939,2445,2896,92388,82595,332,71813,10450,9793
51750,"Radford city, Virginia",889,828,0,720,108,61,12721,11475,90,10331,1054,1246,14356,12971,96,11704,1171,1385
51760,"Richmond city, Virginia",102473,83818,724,64279,18815,18655,83638,78809,276,73004,5529,4829,209861,183421,1000,154616,27805,26440
51770,"Roanoke city, Virginia",27635,23216,93,18005,5118,4419,57853,51267,446,44872,5949,6586,97512,85266,539,72253,12474,12246
51775,"Salem city, Virginia",1625,1136,12,698,426,489,19989,18480,39,16556,1885,1509,23113,21066,51,18459,2556,2047
51790,"Staunton city, Virginia",2367,2108,0,1595,513,259,18992,16943,70,14910,1963,2049,22948,20627,70,17983,2574,2321
51800,"Suffolk city, Virginia",36491,32795,76,26219,6500,3696,43444,41298,310,38557,2431,2146,87377,81417,395,71768,9254,5960
51810,"Virginia Beach city, Virginia",82917,78110,39,68001,10070,4807,274692,264683,550,250713,13420,10009,439383,422224,734,393620,27870,17159
51820,"Waynesboro city, Virginia",2889,2265,0,1589,676,624,16521,13943,25,11623,2295,2578,21445,18243,25,14915,3303,3202
51830,"Williamsburg city, Virginia",1819,1496,0,1236,260,323,7452,7156,31,6645,480,296,10640,9991,31,9035,925,649
51840,"Winchester city, Virginia",2450,1894,18,1559,317,556,17844,15587,69,13746,1772,2257,26500,22451,156,19319,2976,4049
53001,"Adams County, Washington",104,57,0,57,0,47,6602,5973,43,5292,638,629,18988,14888,56,11797,3035,4100
53003,"Asotin County, Washington",105,105,0,89,16,0,20114,18758,198,16545,2015,1356,22045,20495,198,18168,2129,1550
53005,"Benton County, Washington",2828,2663,37,1922,704,165,135082,127355,1434,116372,9549,7727,188863,173502,1635,154520,17347,15361
53007,"Chelan County, Washington",285,275,0,275,0,10,50507,47248,276,41915,5057,3259,73850,67194,424,56083,10687,6656
53009,"Clallam County, Washington",801,628,0,582,46,173,60293,55446,699,51635,3112,4847,72285,66163,800,61567,3796,6122
53011,"Clark County, Washington",8260,7644,0,6750,894,616,360423,346268,1699,324854,19715,14155,453453,436144,2050,408075,26019,17309
53013,"Columbia County, Washington",12,12,0,12,0,0,3382,3049,15,2807,227,333,3908,3515,15,3268,232,393
53015,"Cowlitz County, Washington",786,686,0,653,33,100,86372,79863,620,72255,6988,6509,102332,94264,638,84698,8928,8068
53017,"Douglas County, Washington",105,105,0,105,0,0,26097,24623,186,22328,2109,1474,40224,37804,289,32539,4976,2420
53019,"Ferry County, Washington",0,0,0,0,0,0,5426,4652,273,3756,623,774,7355,6261,284,4906,1071,1094
53021,"Franklin County, Washington",1870,1459,0,1238,221,411,35381,33145,138,30700,2307,2236,86849,74678,192,63942,10544,12171
53023,"Garfield County, Washington",0,0,0,0,0,0,2020,1837,14,1562,261,183,2203,1997,19,1691,287,206
53025,"Grant County, Washington",600,523,0,512,11,77,50589,47331,405,42493,4433,3258,92410,82677,534,72969,9174,9733
53027,"Grays Harbor County, Washington",130,128,0,122,6,2,55094,49768,376,46096,3296,5326,68444,62025,494,57286,4245,6419
53029,"Island County, Washington",2278,1993,0,1866,127,285,62954,60142,376,56648,3118,2812,78120,74389,398,69966,4025,3731
53031,"Jefferson County, Washington",83,83,0,83,0,0,26636,24854,336,23450,1068,1782,29718,27714,351,26189,1174,2004
53033,"King County, Washington",126921,117667,314,104370,12983,9254,1279700,1237364,3847,1186274,47243,42336,2081950,2004567,5398,1904943,94226,77383
53035,"Kitsap County, Washington",6188,5953,0,5717,236,235,195125,187491,620,179246,7625,7634,251831,242359,694,230924,10741,9472
53037,"Kittitas County, Washington",383,328,0,214,114,55,35272,33403,283,30307,2813,1869,41233,39064,455,35129,3480,2169
53039,"Klickitat County, Washington",22,22,0,22,0,0,17236,15663,367,13906,1390,1573,20921,18547,381,16223,1943,2374
53041,"Lewis County, Washington",405,405,0,204,201,0,63176,57506,974,51219,5313,5670,74880,68497,1108,59225,8164,6383
53043,"Lincoln County, Washington",51,51,0,48,3,0,9403,8798,243,7549,1006,605,10221,9568,243,8268,1057,653
53045,"Mason County, Washington",852,437,0,374,63,415,49429,45343,680,41769,2894,4086,60429,54399,841,49379,4179,6030
53047,"Okanogan County, Washington",167,151,0,151,0,16,26772,23426,398,20642,2386,3346,40255,34825,561,29692,4572,5430
53049,"Pacific County, Washington",29,29,0,26,3,0,17097,15249,164,13725,1360,1848,20678,18374,169,16586,1619,2304
53051,"Pend Oreille County, Washington",26,26,0,26,0,0,11507,10369,174,8124,2071,1138,12939,11724,188,9041,2495,1215
53053,"Pierce County, Washington",54647,50825,268,44800,5757,3822,563703,535308,2791,501519,30998,28395,827019,781982,3866,724124,53992,45037
53055,"San Juan County, Washington",104,91,0,91,0,13,14247,13670,182,12396,1092,577,16017,15260,228,13864,1168,757
53057,"Skagit County, Washington",805,746,0,713,33,59,90124,84314,494,78902,4918,5810,119897,111987,563,104498,6926,7910
53059,"Skamania County, Washington",102,72,0,72,0,30,10110,8667,199,7885,583,1443,11438,9853,221,8883,749,1585
53061,"Snohomish County, Washington",20295,19618,0,18598,1020,677,542404,520916,2952,492482,25482,21488,761358,732325,4039,690911,37375,29033
53063,"Spokane County, Washington",7368,6903,61,6070,772,465,406585,382360,2932,357151,22277,24225,474708,446775,3205,416114,27456,27933
53065,"Stevens County, Washington",198,181,0,101,80,17,37848,33505,848,28938,3719,4343,43527,38529,929,32938,4662,4998
53067,"Thurston County, Washington",7725,7461,11,6939,511,264,201792,190680,952,179053,10675,11112,265952,251588,989,235854,14745,14364
53069,"Wahkiakum County, Washington",0,0,0,0,0,0,3592,3241,110,2878,253,351,4050,3699,110,3283,306,351
53071,"Walla Walla County, Washington",323,308,0,272,36,15,40426,37641,154,34071,3416,2785,54563,50430,181,45675,4574,4133
53073,"Whatcom County, Washington",1970,1888,0,1832,56,82,165242,156915,928,147628,8359,8327,207226,195632,1193,182731,11708,11594
53075,"Whitman County, Washington",748,730,0,621,109,18,33293,31625,231,28150,3244,1668,40847,39109,248,34910,3951,1738
53077,"Yakima County, Washington",2266,1989,0,1810,179,277,107783,98349,1272,89604,7473,9434,244642,211338,1876,185409,24053,33304
54001,"Barbour County, West Virginia",60,60,0,60,0,0,15621,13230,280,11411,1539,2391,16225,13784,280,11890,1614,2441
54003,"Berkeley County, West Virginia",8326,7977,54,7324,599,349,93942,86256,946,77089,8221,7686,111004,102460,1035,92229,9196,8544
54005,"Boone County, West Virginia",182,175,0,162,13,7,22610,18735,14,17475,1246,3875,23108,19169,16,17845,1308,3939
54007,"Braxton County, West Virginia",27,27,0,12,15,0,13638,10304,137,8419,1748,3334,13991,10594,137,8687,1770,3397
54009,"Brooke County, West Virginia",274,197,0,168,29,77,21297,18253,114,15591,2548,3044,22075,18897,114,16137,2646,3178
54011,"Cabell County, West Virginia",4215,3466,15,2126,1325,749,83351,74030,623,62773,10634,9321,92177,81645,643,67808,13194,10532
54013,"Calhoun County, West Virginia",2,2,0,2,0,0,7229,5819,100,5151,568,1410,7427,5967,107,5263,597,1460
54015,"Clay County, West Virginia",0,0,0,0,0,0,8625,6938,0,6163,775,1687,8830,7143,9,6353,781,1687
54017,"Doddridge County, West Virginia",0,0,0,0,0,0,7717,6661,81,5336,1244,1056,7931,6872,81,5494,1297,1059
54019,"Fayette County, West Virginia",2064,1754,0,1586,168,310,39885,33955,240,30530,3185,5930,42891,36457,240,32782,3435,6434
54021,"Gilmer County, West Virginia",138,138,0,138,0,0,6217,4855,114,3899,842,1362,6616,5246,114,4285,847,1370
54023,"Grant County, West Virginia",183,122,0,115,7,61,11180,8801,37,8359,405,2379,11544,9068,37,8607,424,2476
54025,"Greenbrier County, West Virginia",879,709,10,598,101,170,32333,26653,219,23804,2630,5680,34871,28965,229,25950,2786,5906
54027,"Hampshire County, West Virginia",226,129,0,102,27,97,21995,16394,125,15035,1234,5601,22860,17068,125,15599,1344,5792
54029,"Hancock County, West Virginia",627,586,0,532,54,41,27901,24371,39,21245,3087,3530,29668,25903,39,22696,3168,3765
54031,"Hardy County, West Virginia",455,315,0,308,7,140,12467,10539,32,9521,986,1928,13730,11354,32,10238,1084,2376
54033,"Harrison County, West Virginia",1107,1032,0,982,50,75,63829,55558,530,50564,4464,8271,67525,58906,530,53580,4796,8619
54035,"Jackson County, West Virginia",27,27,0,12,15,0,28114,22897,308,19755,2834,5217,28947,23714,308,20548,2858,5233
54037,"Jefferson County, West Virginia",3477,3265,0,2702,563,212,45547,42703,272,37666,4765,2844,54200,50947,272,44923,5752,3253
54039,"Kanawha County, West Virginia",12560,11080,9,9253,1818,1480,162386,143995,499,128933,14563,18391,184491,163898,513,146118,17267,20593
54041,"Lewis County, West Virginia",17,17,0,17,0,0,15564,13385,139,11632,1614,2179,16106,13828,139,12028,1661,2278
54043,"Lincoln County, West Virginia",116,26,0,26,0,90,20757,17435,96,16091,1248,3322,21181,17760,96,16408,1256,3421
54045,"Logan County, West Virginia",539,437,0,437,0,102,32519,27646,129,25861,1656,4873,33849,28834,129,26956,1749,5015
54047,"McDowell County, West Virginia",966,585,0,530,55,381,16823,12993,110,10937,1946,3830,18059,13848,110,11692,2046,4211
54049,"Marion County, West Virginia",1833,1593,0,1425,168,240,51456,45186,267,41414,3505,6270,55235,48584,272,44551,3761,6651
54051,"Marshall County, West Virginia",288,264,0,264,0,24,30614,25932,88,22607,3237,4682,31586,26836,91,23501,3244,4750
54053,"Mason County, West Virginia",60,60,0,60,0,0,25504,20925,236,17365,3324,4579,26327,21682,236,18051,3395,4645
54055,"Mercer County, West Virginia",3591,2967,0,2282,685,624,54220,45052,453,38516,6083,9168,59796,49757,453,42343,6961,10039
54057,"Mineral County, West Virginia",779,643,0,541,102,136,25242,19348,139,18205,1004,5894,26633,20451,139,19169,1143,6182
54059,"Mingo County, West Virginia",473,314,0,262,52,159,24070,19981,86,17426,2469,4089,25054,20770,99,18131,2540,4284
54061,"Monongalia County, West Virginia",3192,3118,0,2670,448,74,86694,79783,352,73607,5824,6911,97528,90100,352,82973,6775,7428
54063,"Monroe County, West Virginia",86,76,0,0,76,10,12906,10215,82,8544,1589,2691,13403,10560,82,8734,1744,2843
54065,"Morgan County, West Virginia",119,91,0,83,8,28,16623,14546,226,12805,1515,2077,17378,15235,258,13449,1528,2143
54067,"Nicholas County, West Virginia",158,158,0,143,15,0,24675,21244,126,17965,3153,3431,25348,21867,152,18480,3235,3481
54069,"Ohio County, West Virginia",1544,1184,0,952,232,360,37541,32715,192,27682,4841,4826,40444,35181,192,29778,5211,5263
54071,"Pendleton County, West Virginia",204,76,13,63,0,128,6654,5104,94,4226,784,1550,6976,5292,107,4401,784,1684
54073,"Pleasants County, West Virginia",4,4,0,4,0,0,6899,6048,89,5190,769,851,6965,6114,89,5247,778,851
54075,"Pocahontas County, West Virginia",47,35,0,35,0,12,7932,6518,57,5887,574,1414,8275,6849,57,6218,574,1426
54077,"Preston County, West Virginia",121,121,0,92,29,0,30345,26356,445,23745,2166,3989,31122,27085,445,24425,2215,4037
54079,"Putnam County, West Virginia",690,573,0,411,162,117,53799,48284,351,41406,6527,5515,56367,50624,379,43452,6793,5743
54081,"Raleigh County, West Virginia",5121,4086,16,3605,465,1035,64956,56485,116,52281,4088,8471,73862,63899,152,58806,4941,9963
54083,"Randolph County, West Virginia",382,381,0,357,24,1,26018,21098,164,19106,1828,4920,26945,21945,164,19905,1876,5000
54085,"Ritchie County, West Virginia",0,0,0,0,0,0,9809,8006,117,7115,774,1803,9947,8144,117,7224,803,1803
54087,"Roane County, West Virginia",4,4,0,4,0,0,13818,11230,212,9446,1572,2588,14246,11623,212,9788,1623,2623
54089,"Summers County, West Virginia",415,259,0,256,3,156,11435,9242,17,6436,2789,2193,12195,9769,17,6915,2837,2426
54091,"Taylor County, West Virginia",180,166,0,116,50,14,15910,13509,98,12313,1098,2401,16539,14112,98,12866,1148,2427
54093,"Tucker County, West Virginia",29,29,0,29,0,0,6690,5656,92,5180,384,1034,6858,5819,92,5339,388,1039
54095,"Tyler County, West Virginia",16,16,0,0,16,0,8680,7252,179,6104,969,1428,8860,7396,179,6220,997,1464
54097,"Upshur County, West Virginia",204,193,0,108,85,11,22613,19605,136,17384,2085,3008,23348,20257,169,17790,2298,3091
54099,"Wayne County, West Virginia",102,41,0,30,11,61,39921,33294,357,28593,4344,6627,40907,34103,357,29256,4490,6804
54101,"Webster County, West Virginia",3,3,0,3,0,0,8550,6426,40,5893,493,2124,8581,6457,40,5924,493,2124
54103,"Wetzel County, West Virginia",91,91,0,91,0,0,15276,11968,99,10670,1199,3308,15672,12318,99,11005,1214,3354
54105,"Wirt County, West Virginia",55,55,0,55,0,0,5640,4935,34,4128,773,705,5800,5079,34,4257,788,721
54107,"Wood County, West Virginia",907,786,0,621,165,121,81208,72721,389,66326,6006,8487,85065,76325,389,69588,6348,8740
54109,"Wyoming County, West Virginia",189,98,0,42,56,91,21474,17357,134,15362,1861,4117,22053,17779,134,15689,1956,4274
55001,"Adams County, Wisconsin",135,123,0,109,14,12,17904,15501,256,13508,1737,2403,18957,16453,256,14297,1900,2504
55003,"Ashland County, Wisconsin",60,56,0,14,42,4,12502,11023,102,9700,1221,1479,15166,13304,151,11578,1575,1862
55005,"Barron County, Wisconsin",513,336,0,163,173,177,41891,37477,384,33673,3420,4414,44615,39865,386,35707,3772,4750
55007,"Bayfield County, Wisconsin",96,96,0,96,0,0,12654,11435,115,10356,964,1219,14882,13416,182,12108,1126,1466
55009,"Brown County, Wisconsin",4989,4492,9,4093,390,497,205135,190655,1227,178662,10766,14480,250917,233560,1307,216653,15600,17357
55011,"Buffalo County, Wisconsin",53,53,0,53,0,0,12598,11152,344,9895,913,1446,13128,11628,344,10353,931,1500
55013,"Burnett County, Wisconsin",65,55,0,55,0,10,13708,11944,259,10453,1232,1764,15106,13144,270,11420,1454,1962
55015,"Calumet County, Wisconsin",411,401,0,242,159,10,45227,42758,357,40214,2187,2469,49493,46840,361,43967,2512,2653
55017,"Chippewa County, Wisconsin",261,261,0,259,2,0,58054,53293,557,48206,4530,4761,60874,55928,583,50760,4585,4946
55019,"Clark County, Wisconsin",173,149,0,149,0,24,31736,23082,456,20133,2493,8654,33923,24993,459,21897,2637,8930
55021,"Columbia County, Wisconsin",330,308,0,285,23,22,52071,47104,525,42910,3669,4967,55341,50237,539,45506,4192,5104
55023,"Crawford County, Wisconsin",40,25,0,16,9,15,15067,12858,170,11472,1216,2209,15538,13292,170,11849,1273,2246
55025,"Dane County, Wisconsin",25564,24447,319,20339,3789,1117,408599,392157,2111,368685,21361,16442,508866,488635,2926,452536,33173,20231
55027,"Dodge County, Wisconsin",843,843,0,709,134,0,76766,68941,751,63334,4856,7825,83387,75179,794,68860,5525,8208
55029,"Door County, Wisconsin",158,158,0,155,3,0,25585,23409,195,20902,2312,2176,27082,24819,195,22136,2488,2263
55031,"Douglas County, Wisconsin",418,392,0,369,23,26,39036,35720,769,30995,3956,3316,42234,38684,769,33610,4305,3550
55033,"Dunn County, Wisconsin",183,183,0,183,0,0,38114,35427,522,31974,2931,2687,40740,37815,529,34158,3128,2925
55035,"Eau Claire County, Wisconsin",698,572,0,452,120,126,89124,82356,469,77024,4863,6768,98082,90508,476,84118,5914,7574
55037,"Florence County, Wisconsin",12,0,0,0,0,12,4232,3718,42,3101,575,514,4297,3768,42,3125,601,529
55039,"Fond du Lac County, Wisconsin",1031,705,0,570,135,326,89490,81644,980,75051,5613,7846,98708,89904,983,82012,6909,8804
55041,"Forest County, Wisconsin",23,20,0,12,8,3,7014,5913,121,4951,841,1101,8755,7338,121,5890,1327,1417
55043,"Grant County, Wisconsin",341,305,0,243,62,36,45947,40240,565,36550,3125,5707,47855,42038,589,38016,3433,5817
55045,"Green County, Wisconsin",134,129,0,129,0,5,34476,30968,429,28204,2335,3508,36454,32831,450,29740,2641,3623
55047,"Green Lake County, Wisconsin",110,110,0,102,8,0,17214,14142,330,12573,1239,3072,18518,15429,373,13734,1322,3089
55049,"Iowa County, Wisconsin",146,128,0,112,16,18,22365,20198,300,18413,1485,2167,23350,21156,304,19333,1519,2194
55051,"Iron County, Wisconsin",24,24,0,2,22,0,5410,4746,134,4125,487,664,5626,4931,136,4234,561,695
55053,"Jackson County, Wisconsin",92,92,2,36,54,0,17098,14512,266,12954,1292,2586,19350,16627,270,14817,1540,2723
55055,"Jefferson County, Wisconsin",583,545,0,498,47,38,73022,67051,698,61128,5225,5971,80884,74100,698,67469,5933,6784
55057,"Juneau County, Wisconsin",203,193,0,193,0,10,23152,20359,307,17862,2190,2793,24606,21682,310,18975,2397,2924
55059,"Kenosha County, Wisconsin",11866,10200,0,9114,1086,1666,124777,116206,876,108065,7265,8571,163243,151473,923,138947,11603,11770
55061,"Kewaunee County, Wisconsin",90,88,4,73,11,2,19175,17222,332,15226,1664,1953,20195,18147,336,16032,1779,2048
55063,"La Crosse County, Wisconsin",1403,1311,0,1113,198,92,101501,94199,588,88119,5492,7302,112315,104592,588,97544,6460,7723
55065,"Lafayette County, Wisconsin",38,31,0,30,1,7,15761,13106,217,11881,1008,2655,16641,13841,217,12423,1201,2800
55067,"Langlade County, Wisconsin",126,87,0,81,6,39,17959,15403,219,13587,1597,2556,18938,16211,220,14271,1720,2727
55069,"Lincoln County, Wisconsin",46,39,0,39,0,7,26345,23398,331,20456,2611,2947,27314,24283,337,21208,2738,3031
55071,"Manitowoc County, Wisconsin",507,435,0,354,81,72,71656,64319,770,58145,5404,7337,78554,70622,792,63732,6098,7932
55073,"Marathon County, Wisconsin",800,599,0,571,28,201,119215,107559,1279,99275,7005,11656,133598,121194,1366,111741,8087,12404
55075,"Marinette County, Wisconsin",220,172,0,158,14,48,38079,33732,383,30490,2859,4347,39782,35220,425,31789,3006,4562
55077,"Marquette County, Wisconsin",44,44,0,41,3,0,14023,12129,199,10807,1123,1894,14907,12968,210,11551,1207,1939
55078,"Menominee County, Wisconsin",0,0,0,0,0,0,375,336,11,288,37,39,4446,3370,14,3219,137,1076
55079,"Milwaukee County, Wisconsin",247184,203829,653,162003,41173,43355,484436,441506,2757,410483,28266,42930,933417,823383,3969,726432,92982,110034
55081,"Monroe County, Wisconsin",603,575,0,575,0,28,40645,35039,449,31783,2807,5606,44460,38518,449,35063,3006,5942
55083,"Oconto County, Wisconsin",128,103,0,101,2,25,35438,31760,408,29003,2349,3678,37160,33147,413,30255,2479,4013
55085,"Oneida County, Wisconsin",190,128,0,110,18,62,33174,30223,263,27682,2278,2951,34756,31695,265,29081,2349,3061
55087,"Outagamie County, Wisconsin",2030,2030,42,1872,116,0,159079,148778,1517,139292,7969,10301,180174,168566,1625,156795,10146,11608
55089,"Ozaukee County, Wisconsin",1128,1051,0,1027,24,77,79722,75694,411,72153,3130,4028,86530,82179,423,78133,3623,4351
55091,"Pepin County, Wisconsin",24,17,0,17,0,7,6947,6053,79,5676,298,894,7167,6264,79,5865,320,903
55093,"Pierce County, Wisconsin",188,185,15,140,30,3,36648,33905,417,30634,2854,2743,38512,35605,493,32190,2922,2907
55095,"Polk County, Wisconsin",98,86,0,65,21,12,40816,36738,693,32057,3988,4078,42809,38558,709,33486,4363,4251
55097,"Portage County, Wisconsin",394,371,4,335,32,23,61567,57266,433,53536,3297,4301,66958,62434,456,58098,3880,4524
55099,"Price County, Wisconsin",95,95,0,95,0,0,12641,10846,265,9803,778,1795,13357,11473,274,10279,920,1884
55101,"Racine County, Wisconsin",19746,16272,97,13083,3092,3474,139121,128327,762,120088,7477,10794,190059,171864,866,157641,13357,18195
55103,"Richland County, Wisconsin",110,103,0,102,1,7,16416,14036,229,12379,1428,2380,17187,14693,229,13002,1462,2494
55105,"Rock County, Wisconsin",6825,5109,43,3615,1451,1716,132101,122413,993,108073,13347,9688,158216,145585,1079,125347,19159,12631
55107,"Rusk County, Wisconsin",128,106,0,99,7,22,13352,11245,250,9531,1464,2107,14013,11768,268,9969,1531,2245
55109,"St. Croix County, Wisconsin",666,498,0,463,35,168,81400,77707,511,72247,4949,3693,86299,82241,574,76210,5457,4058
55111,"Sauk County, Wisconsin",376,353,0,288,65,23,57171,50502,663,45980,3859,6669,62449,55498,663,50531,4304,6951
55113,"Sawyer County, Wisconsin",67,64,0,64,0,3,12373,10997,149,9935,913,1376,16047,13899,177,12381,1341,2148
55115,"Shawano County, Wisconsin",81,73,0,43,30,8,35290,30567,415,27940,2212,4723,40469,35172,539,32169,2464,5297
55117,"Sheboygan County, Wisconsin",1459,1439,0,1388,51,20,95892,87784,687,81512,5585,8108,112077,103137,696,96149,6292,8940
55119,"Taylor County, Wisconsin",83,83,0,83,0,0,19422,16002,396,14088,1518,3420,20130,16610,396,14614,1600,3520
55121,"Trempealeau County, Wisconsin",116,115,0,110,5,1,26290,22927,234,21071,1622,3363,29059,25166,234,22970,1962,3893
55123,"Vernon County, Wisconsin",100,89,0,65,24,11,28876,22237,286,19705,2246,6639,29946,23175,286,20461,2428,6771
55125,"Vilas County, Wisconsin",36,7,0,7,0,29,18117,16009,296,13872,1841,2108,21260,18565,296,15781,2488,2695
55127,"Walworth County, Wisconsin",1009,956,0,793,163,53,85515,80192,838,72825,6529,5323,99980,93828,904,84032,8892,6152
55129,"Washburn County, Wisconsin",60,60,0,52,8,0,14584,12897,243,11504,1150,1687,15403,13617,251,12135,1231,1786
55131,"Washington County, Wisconsin",1461,1277,22,1230,25,184,124021,115862,639,109868,5355,8159,132928,124350,710,117805,5835,8578
55133,"Waukesha County, Wisconsin",5640,5231,123,4825,283,409,349443,333655,1547,321098,11010,15788,391604,374335,1730,359765,12840,17269
55135,"Waupaca County, Wisconsin",146,146,0,49,97,0,47439,42244,622,37950,3672,5195,50017,44393,632,39805,3956,5624
55137,"Waushara County, Wisconsin",123,116,0,105,11,7,20970,17725,503,15380,1842,3245,22961,19462,516,16873,2073,3499
55139,"Winnebago County, Wisconsin",2254,2089,0,1801,288,165,145175,132888,1184,122229,9475,12287,161274,147254,1195,135523,10536,14020
55141,"Wood County, Wisconsin",422,340,0,340,0,82,67213,59190,560,55178,3452,8023,72444,63886,569,59630,3687,8558
56001,"Albany County, Wyoming",522,498,0,452,46,24,29566,28597,146,25155,3296,969,35686,34535,146,30382,4007,1151
56003,"Big Horn County, Wyoming",68,68,0,68,0,0,10310,9596,22,8334,1240,714,11670,10766,23,9198,1545,904
56005,"Campbell County, Wyoming",130,120,0,120,0,10,41716,40209,47,37193,2969,1507,47556,45718,47,42487,3184,1838
56007,"Carbon County, Wyoming",172,70,0,70,0,102,11607,10519,191,9218,1110,1088,14849,13100,191,11349,1560,1749
56009,"Converse County, Wyoming",0,0,0,0,0,0,12883,12140,86,10414,1640,743,14106,13277,100,11367,1810,829
56011,"Crook County, Wyoming",15,15,0,15,0,0,6877,6428,63,5245,1120,449,7281,6832,63,5623,1146,449
56013,"Fremont County, Wyoming",181,181,0,131,50,0,27778,25616,121,22691,2804,2162,39500,35728,125,29520,6083,3772
56015,"Goshen County, Wyoming",0,0,0,0,0,0,11050,9709,97,8821,791,1341,12811,11183,97,9829,1257,1628
56017,"Hot Springs County, Wyoming",0,0,0,0,0,0,4394,3926,40,3503,383,468,4650,4169,40,3744,385,481
56019,"Johnson County, Wyoming",121,121,0,121,0,0,7788,6727,67,6118,542,1061,8491,7430,67,6781,582,1061
56021,"Laramie County, Wyoming",2440,2316,0,2196,120,124,75333,71613,459,66289,4865,3720,95022,89697,520,81982,7195,5325
56023,"Lincoln County, Wyoming",56,56,0,56,0,0,17292,16533,186,14189,2158,759,18684,17877,191,15345,2341,807
56025,"Natrona County, Wyoming",1012,995,0,580,415,17,69137,64760,198,58941,5621,4377,79338,74377,228,66852,7297,4961
56027,"Niobrara County, Wyoming",0,0,0,0,0,0,2011,1806,0,1496,310,205,2176,1971,0,1563,408,205
56029,"Park County, Wyoming",135,34,0,34,0,101,25861,24226,376,21845,2005,1635,28443,26636,384,24224,2028,1807
56031,"Platte County, Wyoming",0,0,0,0,0,0,7676,6812,197,5754,861,864,8592,7449,197,6317,935,1143
56033,"Sheridan County, Wyoming",253,253,0,253,0,0,26621,24398,73,23026,1299,2223,28950,26384,73,24910,1401,2566
56035,"Sublette County, Wyoming",0,0,0,0,0,0,8860,8561,60,7990,511,299,9914,9595,84,8584,927,319
56037,"Sweetwater County, Wyoming",328,328,0,328,0,0,34971,33450,385,30896,2169,1521,43907,41980,735,38095,3150,1927
56039,"Teton County, Wyoming",132,132,0,132,0,0,17976,17533,75,15515,1943,443,22036,21462,75,18492,2895,574
56041,"Uinta County, Wyoming",24,24,0,17,7,0,17995,17012,67,15602,1343,983,20499,19450,67,17940,1443,1049
56043,"Washakie County, Wyoming",24,24,0,24,0,0,6689,6223,16,5722,485,466,8090,7533,64,6772,697,557
56045,"Weston County, Wyoming",20,20,0,20,0,0,6252,5516,40,4784,692,736,6758,5945,40,5213,692,813